PLAYER,TEAM,AGE,GP,G,FREQ,FGM,FGA,FG%,EFG%,2FG FREQ,2FGM,2FGA,2FG%,3FG FREQ,3PM,3PA,3P%
Zaza Pachulia,DAL,32,76,69,37.8%,95,178,53.4,53.4,37.6%,95,177,53.7,0.2%,0,1,0
Zach Randolph,MEM,34,68,67,35.5%,158,322,49.1,49.1,35.2%,158,319,49.5,0.3%,0,3,0
Zach LaVine,MIN,21,82,80,35.3%,147,337,43.6,46.4,28.8%,128,275,46.5,6.5%,19,62,30.6
Xavier Munford,MEM,24,14,12,34.2%,10,26,38.5,42.3,27.6%,8,21,38.1,6.6%,2,5,40
Willie Reed,BKN,26,39,30,45.9%,38,61,62.3,62.3,45.9%,38,61,62.3,0.0%,0,0,-
Willie Cauley-Stein,SAC,22,65,55,46.6%,83,157,52.9,52.9,46.6%,83,157,52.9,0.0%,0,0,-
Will Barton,DEN,25,82,80,40.0%,182,393,46.3,49.6,32.5%,156,319,48.9,7.5%,26,74,35.1
Wesley Matthews,DAL,29,78,73,27.5%,89,235,37.9,42.1,18.6%,69,159,43.4,8.9%,20,76,26.3
Wesley Johnson,LAC,28,80,60,24.7%,53,127,41.7,47.6,15.7%,38,81,46.9,8.9%,15,46,32.6
Wayne Ellington,BKN,28,76,67,31.7%,71,178,39.9,44.4,24.4%,55,137,40.1,7.3%,16,41,39
Vince Carter,MEM,39,60,48,33.2%,47,114,41.2,47.8,22.2%,32,76,42.1,11.1%,15,38,39.5
Victor Oladipo,ORL,24,71,70,28.9%,127,274,46.4,48.4,26.1%,116,247,47,2.8%,11,27,40.7
Udonis Haslem,MIA,36,37,12,26.2%,3,16,18.8,18.8,24.6%,3,15,20,1.6%,0,1,0
Tyus Jones,MIN,20,37,33,44.9%,25,70,35.7,37.9,39.7%,22,62,35.5,5.1%,3,8,37.5
Tyson Chandler,PHX,33,66,53,44.1%,87,138,63,63,44.1%,87,138,63,0.0%,0,0,-
Tyreke Evans,NOP,26,25,23,38.3%,57,120,47.5,48.8,34.2%,54,107,50.5,4.2%,3,13,23.1
Tyler Zeller,BOS,26,59,44,34.0%,54,98,55.1,55.1,34.0%,54,98,55.1,0.0%,0,0,-
Tyler Johnson,MIA,24,36,30,37.2%,43,90,47.8,48.3,34.3%,42,83,50.6,2.9%,1,7,14.3
Tyler Hansbrough,CHA,30,44,14,33.8%,13,24,54.2,54.2,33.8%,13,24,54.2,0.0%,0,0,-
Tyler Ennis,MIL,21,46,37,43.9%,39,82,47.6,47.6,43.3%,39,81,48.1,0.5%,0,1,0
Ty Lawson,IND,28,66,51,32.3%,45,114,39.5,39.5,29.7%,45,105,42.9,2.5%,0,9,0
Troy Daniels,CHA,24,43,30,28.3%,21,53,39.6,47.2,16.0%,13,30,43.3,12.3%,8,23,34.8
Tristan Thompson,CLE,25,82,72,48.1%,116,201,57.7,57.7,48.1%,116,201,57.7,0.0%,0,0,-
Trey Lyles,UTA,20,80,62,32.9%,73,143,51,52.4,30.3%,69,132,52.3,2.5%,4,11,36.4
Trey Burke,UTA,23,64,59,34.5%,106,219,48.4,53.2,26.0%,85,165,51.5,8.5%,21,54,38.9
Trevor Booker,UTA,28,79,63,39.3%,78,152,51.3,51.3,38.8%,78,150,52,0.5%,0,2,0
Trevor Ariza,HOU,31,81,79,25.9%,90,222,40.5,44.4,17.5%,73,150,48.7,8.4%,17,72,23.6
Tony Wroten,NYK,23,8,8,33.8%,9,22,40.9,40.9,30.8%,9,20,45,3.1%,0,2,0
Tony Snell,CHI,24,64,49,28.0%,32,95,33.7,36.3,23.0%,27,78,34.6,5.0%,5,17,29.4
Tony Parker,SAS,34,72,68,36.8%,130,261,49.8,50.6,36.0%,126,255,49.4,0.8%,4,6,66.7
Tony Allen,MEM,34,64,60,36.5%,89,171,52,52,35.9%,89,168,53,0.6%,0,3,0
Toney Douglas,NOP,30,61,49,31.9%,66,142,46.5,50,26.5%,56,118,47.5,5.4%,10,24,41.7
Tobias Harris,DET,23,75,74,32.5%,145,284,51.1,51.6,31.4%,142,274,51.8,1.1%,3,10,30
Timofey Mozgov,CLE,29,76,60,43.3%,100,155,64.5,64.5,43.3%,100,155,64.5,0.0%,0,0,-
Tim Hardaway Jr.,ATL,24,51,38,31.9%,37,84,44,47.6,23.2%,31,61,50.8,8.7%,6,23,26.1
Tim Frazier,NOP,25,51,31,36.2%,28,83,33.7,34.9,35.4%,26,81,32.1,0.9%,2,2,100
Tim Duncan,SAS,40,61,57,37.0%,86,163,52.8,52.8,36.7%,86,162,53.1,0.2%,0,1,0
Tibor Pleiss,UTA,26,12,5,32.0%,4,8,50,50,32.0%,4,8,50,0.0%,0,0,-
Tiago Splitter,ATL,31,36,33,49.7%,47,77,61,61,49.7%,47,77,61,0.0%,0,0,-
Thomas Robinson,BKN,25,71,46,39.5%,54,115,47,47,39.5%,54,115,47,0.0%,0,0,-
Thanasis Antetokounmpo,NYK,23,2,1,25.0%,1,1,100,100,25.0%,1,1,100,0.0%,0,0,-
Thaddeus Young,BKN,28,73,73,42.2%,219,405,54.1,54.2,41.8%,218,401,54.4,0.4%,1,4,25
Thabo Sefolosha,ATL,32,75,55,26.6%,51,98,52,53.1,25.2%,49,93,52.7,1.4%,2,5,40
Terry Rozier,BOS,22,38,25,42.7%,8,44,18.2,18.2,38.8%,8,40,20,3.9%,0,4,0
Terrence Ross,TOR,25,72,67,38.7%,101,239,42.3,49.2,22.9%,68,141,48.2,15.9%,33,98,33.7
Terrence Jones,HOU,24,50,42,37.1%,66,135,48.9,49.3,35.2%,65,128,50.8,1.9%,1,7,14.3
Tayshaun Prince,MIN,36,77,39,28.2%,29,64,45.3,46.1,26.0%,28,59,47.5,2.2%,1,5,20
Tarik Black,LAL,24,39,25,43.3%,27,45,60,60,43.3%,27,45,60,0.0%,0,0,-
Taj Gibson,CHI,31,73,68,40.6%,109,203,53.7,53.7,40.6%,109,203,53.7,0.0%,0,0,-
TJ Warren,PHX,22,47,45,39.1%,91,172,52.9,53.8,37.0%,88,163,54,2.0%,3,9,33.3
TJ McConnell,PHI,24,81,75,42.5%,89,197,45.2,45.2,41.6%,89,193,46.1,0.9%,0,4,0
Steven Adams,OKC,22,80,77,51.9%,141,219,64.4,64.4,51.9%,141,219,64.4,0.0%,0,0,-
Steve Novak,MIL,33,10,4,38.9%,3,7,42.9,64.3,5.6%,0,1,0,33.3%,3,6,50
Steve Blake,DET,36,58,43,26.7%,20,64,31.3,36.7,15.8%,13,38,34.2,10.8%,7,26,26.9
Stephen Curry,GSW,28,79,78,34.5%,270,550,49.1,57.6,19.7%,176,314,56.1,14.8%,94,236,39.8
Stanley Johnson,DET,20,73,68,30.1%,73,180,40.6,41.1,27.7%,71,166,42.8,2.3%,2,14,14.3
Spencer Hawes,CHA,28,57,39,29.5%,41,90,45.6,45.6,29.2%,41,89,46.1,0.3%,0,1,0
Spencer Dinwiddie,CHI,23,12,10,54.7%,11,29,37.9,37.9,50.9%,11,27,40.7,3.8%,0,2,0
Sonny Weems,PHX,29,43,17,23.9%,11,26,42.3,46.2,19.3%,9,21,42.9,4.6%,2,5,40
Solomon Hill,IND,25,59,30,34.3%,30,71,42.3,45.1,30.4%,26,63,41.3,3.9%,4,8,50
Shelvin Mack,UTA,26,52,45,37.6%,77,155,49.7,51,35.4%,73,146,50,2.2%,4,9,44.4
Shayne Whittington,IND,25,7,1,9.1%,1,1,100,100,9.1%,1,1,100,0.0%,0,0,-
Shaun Livingston,GSW,30,78,75,53.0%,103,201,51.2,51.2,52.2%,103,198,52,0.8%,0,3,0
Shane Larkin,BKN,23,78,74,36.9%,84,185,45.4,45.9,35.1%,82,176,46.6,1.8%,2,9,22.2
Shabazz Napier,ORL,24,55,32,31.3%,17,63,27,31,20.9%,12,42,28.6,10.4%,5,21,23.8
Shabazz Muhammad,MIN,23,82,75,35.6%,128,242,52.9,52.9,33.7%,128,229,55.9,1.9%,0,13,0
Seth Curry,SAC,25,43,32,35.0%,34,77,44.2,50,23.6%,25,52,48.1,11.4%,9,25,36
Sergey Karasev,BKN,22,40,20,38.4%,11,28,39.3,41.1,27.4%,10,20,50,11.0%,1,8,12.5
Serge Ibaka,OKC,26,78,74,24.0%,114,208,54.8,55.3,23.0%,112,199,56.3,1.0%,2,9,22.2
Sean Kilpatrick,BKN,26,31,24,30.7%,42,83,50.6,53.6,25.6%,37,69,53.6,5.2%,5,14,35.7
Sasha Vujacic,NYK,32,61,45,30.4%,26,84,31,36.3,19.9%,17,55,30.9,10.5%,9,29,31
Sasha Kaun,CLE,31,25,5,35.3%,2,6,33.3,33.3,35.3%,2,6,33.3,0.0%,0,0,-
Salah Mejri,DAL,30,34,18,42.3%,26,33,78.8,78.8,42.3%,26,33,78.8,0.0%,0,0,-
Ryan Kelly,LAL,25,36,22,31.5%,17,47,36.2,37.2,29.5%,16,44,36.4,2.0%,1,3,33.3
Ryan Hollins,MEM,31,37,24,58.2%,27,46,58.7,58.7,58.2%,27,46,58.7,0.0%,0,0,-
Ryan Anderson,NOP,28,66,65,29.3%,112,271,41.3,41.9,26.4%,109,244,44.7,2.9%,3,27,11.1
Russell Westbrook,OKC,27,80,80,38.4%,252,554,45.5,46.6,33.8%,240,487,49.3,4.6%,12,67,17.9
Russ Smith,MEM,25,15,6,31.8%,0,7,0,0,22.7%,0,5,0,9.1%,0,2,0
Rudy Gobert,UTA,24,61,57,45.5%,95,161,59,59,45.5%,95,161,59,0.0%,0,0,-
Rudy Gay,SAC,29,69,68,41.0%,193,407,47.4,48.5,38.7%,184,384,47.9,2.3%,9,23,39.1
Roy Hibbert,LAL,29,81,68,40.9%,82,167,49.1,49.1,40.7%,82,166,49.4,0.2%,0,1,0
Ronnie Price,PHX,33,62,43,28.2%,25,85,29.4,35.9,14.3%,14,43,32.6,14.0%,11,42,26.2
Rondae Hollis-Jefferson,BKN,21,29,22,37.0%,17,51,33.3,33.3,37.0%,17,51,33.3,0.0%,0,0,-
Rodney Stuckey,IND,30,58,55,44.1%,84,195,43.1,45.1,38.7%,76,171,44.4,5.4%,8,24,33.3
Rodney Hood,UTA,23,79,74,33.4%,129,324,39.8,44.9,22.7%,96,220,43.6,10.7%,33,104,31.7
Robin Lopez,NYK,28,82,78,40.6%,153,269,56.9,56.9,40.6%,153,269,56.9,0.0%,0,0,-
Robert Sacre,LAL,27,25,19,50.7%,15,38,39.5,39.5,50.7%,15,38,39.5,0.0%,0,0,-
Robert Covington,PHI,25,67,66,36.8%,104,262,39.7,49.6,16.0%,52,114,45.6,20.8%,52,148,35.1
Ricky Rubio,MIN,25,76,69,28.3%,60,166,36.1,38.3,24.9%,53,146,36.3,3.4%,7,20,35
Richaun Holmes,PHI,22,51,36,29.7%,43,66,65.2,65.2,28.4%,43,63,68.3,1.4%,0,3,0
Richard Jefferson,CLE,36,74,47,31.6%,32,98,32.7,35.2,19.0%,27,59,45.8,12.6%,5,39,12.8
Reggie Jackson,DET,26,79,79,43.2%,233,536,43.5,45,38.5%,217,478,45.4,4.7%,16,58,27.6
Reggie Bullock,DET,25,37,17,28.6%,12,28,42.9,46.4,21.4%,10,21,47.6,7.1%,2,7,28.6
Raymond Felton,DAL,32,80,77,34.2%,107,233,45.9,47,30.5%,102,208,49,3.7%,5,25,20
Ray McCallum,SAS,25,41,21,29.0%,18,42,42.9,44,26.9%,17,39,43.6,2.1%,1,3,33.3
Raul Neto,UTA,24,81,68,29.0%,55,121,45.5,48.3,24.9%,48,104,46.2,4.1%,7,17,41.2
Rasual Butler,SAS,37,46,21,28.8%,14,30,46.7,46.7,19.2%,14,20,70,9.6%,0,10,0
Rashad Vaughn,MIL,19,70,48,34.5%,29,91,31.9,35.2,23.5%,23,62,37.1,11.0%,6,29,20.7
Randy Foye,OKC,32,81,65,32.4%,56,156,35.9,39.1,23.1%,46,111,41.4,9.4%,10,45,22.2
Ramon Sessions,WAS,30,82,76,36.9%,114,218,52.3,52.3,35.7%,114,211,54,1.2%,0,7,0
Rakeem Christmas,IND,24,1,1,50.0%,1,1,100,100,50.0%,1,1,100,0.0%,0,0,-
Rajon Rondo,SAC,30,71,69,37.4%,144,290,49.7,51.4,33.4%,134,259,51.7,4.0%,10,31,32.3
RJ Hunter,BOS,22,35,15,24.7%,10,23,43.5,50,18.3%,7,17,41.2,6.5%,3,6,50
Quincy Acy,SAC,25,58,33,28.1%,41,59,69.5,69.5,27.6%,41,58,70.7,0.5%,0,1,0
Phil Pressey,POR,25,23,12,27.3%,11,21,52.4,52.4,27.3%,11,21,52.4,0.0%,0,0,-
Paul Pierce,LAC,38,68,57,33.8%,48,134,35.8,41,20.9%,34,83,41,12.8%,14,51,27.5
Paul Millsap,ATL,31,81,80,39.7%,219,422,51.9,52.1,38.9%,217,413,52.5,0.8%,2,9,22.2
Paul George,IND,26,81,80,39.4%,220,569,38.7,42.4,28.4%,178,411,43.3,10.9%,42,158,26.6
Pau Gasol,CHI,35,72,71,31.5%,139,313,44.4,44.6,31.1%,138,309,44.7,0.4%,1,4,25
Patty Mills,SAS,27,81,70,26.8%,77,164,47,53.4,19.0%,56,116,48.3,7.8%,21,48,43.8
Patrick Patterson,TOR,27,78,65,29.3%,60,142,42.3,44.4,22.9%,54,111,48.6,6.4%,6,31,19.4
Patrick Beverley,HOU,27,71,66,29.8%,77,177,43.5,48,22.6%,61,134,45.5,7.2%,16,43,37.2
Pat Connaughton,POR,23,34,13,30.6%,3,15,20,20,22.4%,3,11,27.3,8.2%,0,4,0
Pablo Prigioni,LAC,39,59,23,24.5%,15,36,41.7,43.1,19.0%,14,28,50,5.4%,1,8,12.5
PJ Tucker,PHX,31,82,68,28.0%,70,163,42.9,43.9,24.4%,67,142,47.2,3.6%,3,21,14.3
PJ Hairston,MEM,23,66,53,29.0%,45,118,38.1,41.1,20.6%,38,84,45.2,8.4%,7,34,20.6
Otto Porter,WAS,23,75,61,22.3%,84,160,52.5,54.4,19.9%,78,143,54.5,2.4%,6,17,35.3
Orlando Johnson,NOP,27,7,4,20.6%,2,7,28.6,28.6,11.8%,2,4,50,8.8%,0,3,0
Omri Casspi,SAC,28,69,66,29.3%,83,182,45.6,46.4,27.3%,80,170,47.1,1.9%,3,12,25
Omer Asik,NOP,29,68,42,53.9%,59,104,56.7,56.7,53.9%,59,104,56.7,0.0%,0,0,-
O.J. Mayo,MIL,28,41,36,33.6%,33,108,30.6,31.9,24.9%,30,80,37.5,8.7%,3,28,10.7
Norris Cole,NOP,27,45,43,35.7%,66,173,38.2,39.3,32.2%,62,156,39.7,3.5%,4,17,23.5
Norman Powell,TOR,23,48,31,28.8%,30,66,45.5,47,25.3%,28,58,48.3,3.5%,2,8,25
Noah Vonleh,POR,20,78,53,29.5%,46,82,56.1,56.1,29.1%,46,81,56.8,0.4%,0,1,0
Nikola Vucevic,ORL,25,64,64,40.1%,223,410,54.4,54.4,40.0%,223,409,54.5,0.1%,0,1,0
Nikola Pekovic,MIN,30,12,12,66.0%,11,33,33.3,33.3,66.0%,11,33,33.3,0.0%,0,0,-
Nikola Mirotic,CHI,25,66,54,24.3%,69,148,46.6,52,18.1%,53,110,48.2,6.3%,16,38,42.1
Nikola Jokic,DEN,21,80,72,38.7%,129,232,55.6,55.6,38.7%,129,232,55.6,0.0%,0,0,-
Nik Stauskas,PHI,22,73,62,26.8%,64,146,43.8,47.6,19.1%,53,104,51,7.7%,11,42,26.2
Nicolas Batum,CHA,27,70,66,37.4%,121,326,37.1,42,24.3%,89,212,42,13.1%,32,114,28.1
Nick Young,LAL,31,54,53,46.8%,58,174,33.3,42.2,19.4%,27,72,37.5,27.4%,31,102,30.4
Nick Collison,OKC,35,59,29,42.2%,23,46,50,50,42.2%,23,46,50,0.0%,0,0,-
Nerlens Noel,PHI,22,67,65,41.5%,120,243,49.4,49.4,41.5%,120,243,49.4,0.0%,0,0,-
Nene,WAS,33,57,52,37.2%,82,143,57.3,57.3,37.2%,82,143,57.3,0.0%,0,0,-
Nemanja Bjelica,MIN,28,60,37,23.0%,35,54,64.8,67.6,19.6%,32,46,69.6,3.4%,3,8,37.5
Nazr Mohammed,OKC,38,5,2,40.0%,2,2,100,100,40.0%,2,2,100,0.0%,0,0,-
Myles Turner,IND,20,60,53,34.9%,100,185,54.1,54.1,34.7%,100,184,54.3,0.2%,0,1,0
Montrezl Harrell,HOU,22,39,23,46.0%,28,40,70,70,46.0%,28,40,70,0.0%,0,0,-
Monta Ellis,IND,30,81,80,39.4%,175,402,43.5,45.8,33.7%,157,344,45.6,5.7%,18,58,31
Mo Williams,CLE,33,41,36,42.1%,54,127,42.5,47.2,32.5%,42,98,42.9,9.6%,12,29,41.4
Mitch McGary,OKC,24,20,5,34.8%,6,8,75,75,34.8%,6,8,75,0.0%,0,0,-
Mirza Teletovic,PHX,30,79,69,33.7%,109,261,41.8,48.9,20.5%,72,159,45.3,13.2%,37,102,36.3
Miles Plumlee,MIL,27,61,46,49.8%,67,116,57.8,57.8,49.8%,67,116,57.8,0.0%,0,0,-
Mike Scott,ATL,27,75,53,28.0%,51,105,48.6,50.5,24.5%,47,92,51.1,3.5%,4,13,30.8
Mike Muscala,ATL,24,60,28,29.8%,27,45,60,60,29.8%,27,45,60,0.0%,0,0,-
Mike Miller,DEN,36,47,3,4.8%,2,3,66.7,83.3,1.6%,1,1,100,3.2%,1,2,50
Mike Dunleavy,CHI,35,31,27,34.2%,25,64,39.1,43,24.6%,20,46,43.5,9.6%,5,18,27.8
Mike Conley,MEM,28,56,53,31.3%,87,218,39.9,40.8,28.4%,83,198,41.9,2.9%,4,20,20
Michael Kidd-Gilchrist,CHA,22,7,7,39.3%,14,24,58.3,58.3,37.7%,14,23,60.9,1.6%,0,1,0
Michael Carter-Williams,MIL,24,54,53,42.5%,104,236,44.1,44.5,40.7%,102,226,45.1,1.8%,2,10,20
Michael Beasley,HOU,27,20,18,44.9%,53,92,57.6,57.6,44.4%,53,91,58.2,0.5%,0,1,0
Meyers Leonard,POR,24,61,40,18.4%,32,80,40,41.9,14.9%,29,65,44.6,3.4%,3,15,20
Metta World Peace,LAL,36,35,24,23.7%,13,42,31,34.5,17.5%,10,31,32.3,6.2%,3,11,27.3
Maurice Harkless,POR,23,78,61,33.7%,77,138,55.8,56.9,30.8%,74,126,58.7,2.9%,3,12,25
Matthew Dellavedova,CLE,25,76,63,31.9%,64,163,39.3,41.4,26.8%,57,137,41.6,5.1%,7,26,26.9
Matt Bonner,SAS,36,30,9,19.3%,8,11,72.7,72.7,17.5%,8,10,80,1.8%,0,1,0
Matt Barnes,MEM,36,76,64,25.9%,83,179,46.4,50,19.9%,70,138,50.7,5.9%,13,41,31.7
Mason Plumlee,POR,26,82,79,44.7%,119,230,51.7,51.7,44.4%,119,228,52.2,0.4%,0,2,0
Marvin Williams,CHA,30,81,70,25.5%,108,190,56.8,60.8,21.6%,93,161,57.8,3.9%,15,29,51.7
Marreese Speights,GSW,28,72,54,30.5%,49,139,35.3,35.6,29.5%,48,134,35.8,1.1%,1,5,20
Markieff Morris,WAS,26,64,63,31.0%,107,222,48.2,48.4,30.3%,106,217,48.8,0.7%,1,5,20
Markel Brown,BKN,24,62,40,31.9%,40,102,39.2,42.2,25.0%,34,80,42.5,6.9%,6,22,27.3
Mario Hezonja,ORL,21,78,53,30.9%,54,128,42.2,43.4,24.4%,51,101,50.5,6.5%,3,27,11.1
Mario Chalmers,MIA,30,61,56,36.6%,68,162,42,43.5,31.6%,63,140,45,5.0%,5,22,22.7
Marcus Thornton,WAS,29,61,57,41.3%,85,224,37.9,42,27.7%,67,150,44.7,13.7%,18,74,24.3
Marcus Smart,BOS,22,61,59,35.9%,65,190,34.2,36.8,26.5%,55,140,39.3,9.5%,10,50,20
Marcus Morris,DET,26,80,79,41.6%,162,392,41.3,42.2,36.6%,155,345,44.9,5.0%,7,47,14.9
Marco Belinelli,SAC,30,67,63,32.9%,77,206,37.4,41,22.6%,62,142,43.7,10.2%,15,64,23.4
Marcin Gortat,WAS,32,75,75,53.9%,239,412,58,58,53.9%,239,412,58,0.0%,0,0,-
Marcelo Huertas,LAL,33,53,41,39.6%,44,91,48.4,48.4,38.3%,44,88,50,1.3%,0,3,0
Marc Gasol,MEM,31,52,50,31.3%,115,221,52,52,31.3%,115,221,52,0.0%,0,0,-
Manu Ginobili,SAS,38,58,50,27.9%,48,121,39.7,41.7,24.2%,43,105,41,3.7%,5,16,31.3
Luol Deng,MIA,31,74,69,33.8%,130,252,51.6,53.2,30.6%,122,228,53.5,3.2%,8,24,33.3
Luke Babbitt,NOP,27,47,27,37.4%,44,108,40.7,40.7,34.9%,44,101,43.6,2.4%,0,7,0
Luis Scola,TOR,36,75,66,36.6%,102,216,47.2,48.4,33.9%,97,200,48.5,2.7%,5,16,31.3
Luis Montero,POR,23,12,4,26.3%,1,5,20,20,10.5%,1,2,50,15.8%,0,3,0
Lucas Nogueira,TOR,23,29,10,50.0%,15,22,68.2,68.2,50.0%,15,22,68.2,0.0%,0,0,-
Luc Mbah a Moute,LAC,29,75,41,35.7%,40,74,54.1,54.7,34.3%,39,71,54.9,1.4%,1,3,33.3
Lou Williams,LAL,29,67,67,40.3%,112,279,40.1,47,24.0%,74,166,44.6,16.3%,38,113,33.6
Lou Amundson,NYK,33,29,13,38.5%,10,20,50,50,38.5%,10,20,50,0.0%,0,0,-
Lorenzo Brown,DET,25,8,7,40.0%,5,10,50,50,36.0%,5,9,55.6,4.0%,0,1,0
Leandro Barbosa,GSW,33,68,56,31.9%,59,118,50,50.8,29.5%,57,109,52.3,2.4%,2,9,22.2
LeBron James,CLE,31,76,76,37.9%,294,535,55,55.9,35.1%,284,496,57.3,2.8%,10,39,25.6
Lavoy Allen,IND,27,79,58,36.5%,72,135,53.3,53.3,36.5%,72,135,53.3,0.0%,0,0,-
Larry Nance Jr.,LAL,23,63,43,34.3%,59,103,57.3,57.3,34.3%,59,103,57.3,0.0%,0,0,-
Langston Galloway,NYK,24,82,69,35.9%,89,211,42.2,46,27.6%,73,162,45.1,8.3%,16,49,32.7
Lance Thomas,NYK,28,59,49,32.2%,51,123,41.5,42.7,29.3%,48,112,42.9,2.9%,3,11,27.3
Lance Stephenson,MEM,25,69,54,32.9%,83,156,53.2,53.5,31.6%,82,150,54.7,1.3%,1,6,16.7
Lamar Patterson,ATL,24,35,12,17.7%,8,14,57.1,64.3,15.2%,6,12,50,2.5%,2,2,100
LaMarcus Aldridge,SAS,30,74,74,35.6%,202,372,54.3,54.3,35.4%,202,370,54.6,0.2%,0,2,0
Kyrie Irving,CLE,24,53,53,41.5%,158,364,43.4,45.9,34.2%,140,300,46.7,7.3%,18,64,28.1
Kyle Singler,OKC,28,68,37,26.2%,27,58,46.6,48.3,23.5%,25,52,48.1,2.7%,2,6,33.3
Kyle O'Quinn,NYK,26,65,40,24.0%,26,65,40,40,23.6%,26,64,40.6,0.4%,0,1,0
Kyle Lowry,TOR,30,76,76,40.7%,196,479,40.9,46.9,26.5%,139,312,44.6,14.2%,57,167,34.1
Kyle Korver,ATL,35,80,75,33.1%,88,203,43.3,53.4,15.8%,47,97,48.5,17.3%,41,106,38.7
Kyle Anderson,SAS,22,78,52,34.4%,41,101,40.6,40.6,34.0%,41,100,41,0.3%,0,1,0
Kristaps Porzingis,NYK,20,72,70,36.0%,132,318,41.5,41.8,34.4%,130,304,42.8,1.6%,2,14,14.3
Kris Humphries,ATL,31,53,41,24.1%,36,71,50.7,50.7,22.8%,36,67,53.7,1.4%,0,4,0
Kostas Papanikolaou,DEN,25,26,10,27.3%,6,18,33.3,33.3,21.2%,6,14,42.9,6.1%,0,4,0
Kosta Koufos,SAC,27,77,67,53.4%,125,233,53.6,53.6,53.4%,125,233,53.6,0.0%,0,0,-
Kobe Bryant,LAL,37,66,65,53.2%,208,591,35.2,40.4,34.8%,147,386,38.1,18.5%,61,205,29.8
Klay Thompson,GSW,26,80,80,37.1%,231,513,45,50.7,26.2%,173,363,47.7,10.8%,58,150,38.7
Kirk Hinrich,ATL,35,46,27,28.7%,13,37,35.1,39.2,23.3%,10,30,33.3,5.4%,3,7,42.9
Khris Middleton,MIL,24,79,79,48.8%,236,556,42.4,45.7,38.0%,200,433,46.2,10.8%,36,123,29.3
Kevon Looney,GSW,20,5,1,14.3%,1,1,100,100,14.3%,1,1,100,0.0%,0,0,-
Kevin Seraphin,NYK,26,48,38,48.5%,43,99,43.4,43.4,48.0%,43,98,43.9,0.5%,0,1,0
Kevin Martin,SAS,33,55,51,47.0%,70,197,35.5,39.3,36.5%,55,153,35.9,10.5%,15,44,34.1
Kevin Love,CLE,27,77,72,27.3%,125,266,47,49.8,23.7%,110,231,47.6,3.6%,15,35,42.9
Kevin Garnett,MIN,40,38,24,28.7%,12,33,36.4,36.4,28.7%,12,33,36.4,0.0%,0,0,-
Kevin Durant,OKC,27,72,72,49.2%,345,678,50.9,55.8,36.5%,279,503,55.5,12.7%,66,175,37.7
Kentavious Caldwell-Pope,DET,23,76,74,35.0%,154,335,46,48.2,28.0%,139,268,51.9,7.0%,15,67,22.4
Kent Bazemore,ATL,26,75,73,31.6%,112,228,49.1,50,28.4%,108,205,52.7,3.2%,4,23,17.4
Kenneth Faried,DEN,26,67,66,46.0%,161,288,55.9,55.9,46.0%,161,288,55.9,0.0%,0,0,-
Kendrick Perkins,NOP,31,37,17,44.0%,23,33,69.7,69.7,44.0%,23,33,69.7,0.0%,0,0,-
Kendall Marshall,PHI,24,30,21,29.1%,15,34,44.1,44.1,28.2%,15,33,45.5,0.9%,0,1,0
Kemba Walker,CHA,26,81,81,38.1%,206,506,40.7,44.2,29.0%,171,386,44.3,9.0%,35,120,29.2
Kelly Oubre Jr.,WAS,20,63,38,32.7%,33,69,47.8,49.3,29.4%,31,62,50,3.3%,2,7,28.6
Kelly Olynyk,BOS,25,68,59,29.4%,71,160,44.4,44.7,27.6%,70,150,46.7,1.8%,1,10,10
Keith Appling,ORL,24,5,3,50.0%,2,4,50,50,37.5%,2,3,66.7,12.5%,0,1,0
Kawhi Leonard,SAS,25,72,72,35.1%,202,382,52.9,54.3,32.0%,191,348,54.9,3.1%,11,34,32.4
Karl-Anthony Towns,MIN,20,82,80,30.8%,214,354,60.5,60.7,30.3%,212,349,60.7,0.4%,2,5,40
KJ McDaniels,HOU,23,37,13,25.0%,6,18,33.3,33.3,23.6%,6,17,35.3,1.4%,0,1,0
Jusuf Nurkic,DEN,21,32,30,49.4%,53,119,44.5,44.5,49.4%,53,119,44.5,0.0%,0,0,-
Justise Winslow,MIA,20,78,69,36.1%,75,167,44.9,45.2,34.3%,74,159,46.5,1.7%,1,8,12.5
Justin Holiday,CHI,27,53,30,30.4%,21,69,30.4,31.9,25.6%,19,58,32.8,4.8%,2,11,18.2
Justin Harper,BKN,26,5,1,10.0%,0,1,0,0,10.0%,0,1,0,0.0%,0,0,-
Justin Anderson,DAL,22,55,31,26.4%,19,46,41.3,43.5,21.8%,17,38,44.7,4.6%,2,8,25
Julius Randle,LAL,21,81,75,35.6%,144,297,48.5,48.7,35.5%,143,296,48.3,0.1%,1,1,100
Jrue Holiday,NOP,26,65,65,39.1%,173,365,47.4,48.9,35.3%,162,330,49.1,3.7%,11,35,31.4
Josh Smith,HOU,30,55,43,29.8%,47,104,45.2,45.2,27.5%,47,96,49,2.3%,0,8,0
Josh Richardson,MIA,22,52,36,40.4%,46,110,41.8,45.9,30.9%,37,84,44,9.6%,9,26,34.6
Josh McRoberts,MIA,29,42,23,27.7%,21,41,51.2,52.4,27.0%,20,40,50,0.7%,1,1,100
Josh Huestis,OKC,24,5,3,33.3%,0,4,0,0,25.0%,0,3,0,8.3%,0,1,0
Jose Calderon,NYK,34,72,58,30.3%,57,137,41.6,46.4,21.5%,44,97,45.4,8.8%,13,40,32.5
Jorge Gutierrez,CHA,27,12,3,45.5%,3,5,60,60,36.4%,3,4,75,9.1%,0,1,0
Jordan Mickey,BOS,21,16,9,63.6%,5,14,35.7,35.7,63.6%,5,14,35.7,0.0%,0,0,-
Jordan McRae,CLE,25,22,12,38.5%,13,30,43.3,43.3,35.9%,13,28,46.4,2.6%,0,2,0
Jordan Hill,IND,28,73,69,35.2%,107,193,55.4,55.4,35.0%,107,192,55.7,0.2%,0,1,0
Jordan Hamilton,NOP,25,11,10,30.2%,14,35,40,40,27.6%,14,32,43.8,2.6%,0,3,0
Jordan Farmar,MEM,29,12,10,41.0%,21,41,51.2,56.1,31.0%,17,31,54.8,10.0%,4,10,40
Jordan Clarkson,LAL,24,79,79,36.9%,175,405,43.2,45.3,31.3%,158,343,46.1,5.7%,17,62,27.4
Jordan Adams,MEM,21,2,2,50.0%,0,3,0,0,50.0%,0,3,0,0.0%,0,0,-
Jonathon Simmons,SAS,26,55,41,44.4%,57,107,53.3,54.7,41.5%,54,100,54,2.9%,3,7,42.9
Jonas Valanciunas,TOR,24,59,59,48.0%,151,252,59.9,59.9,48.0%,151,252,59.9,0.0%,0,0,-
Jonas Jerebko,BOS,29,77,52,29.4%,35,83,42.2,42.2,27.3%,35,77,45.5,2.1%,0,6,0
Jon Leuer,PHX,27,67,58,35.9%,86,167,51.5,52.1,34.4%,84,160,52.5,1.5%,2,7,28.6
Johnny O'Bryant III,MIL,23,66,40,33.0%,27,69,39.1,39.1,33.0%,27,69,39.1,0.0%,0,0,-
John Wall,WAS,25,77,76,33.7%,192,454,42.3,44.1,30.3%,176,408,43.1,3.4%,16,46,34.8
John Jenkins,PHX,25,43,29,35.0%,28,56,50,51.8,27.5%,26,44,59.1,7.5%,2,12,16.7
John Henson,MIL,25,57,50,59.1%,104,172,60.5,60.5,59.1%,104,172,60.5,0.0%,0,0,-
Joffrey Lauvergne,DEN,24,59,49,35.9%,80,136,58.8,58.8,35.6%,80,135,59.3,0.3%,0,1,0
Joel Anthony,DET,33,19,3,50.0%,3,5,60,60,50.0%,3,5,60,0.0%,0,0,-
Joe Young,IND,24,41,28,33.7%,22,57,38.6,40.4,29.6%,20,50,40,4.1%,2,7,28.6
Joe Johnson,MIA,35,81,78,34.1%,124,293,42.3,44.7,29.4%,110,252,43.7,4.8%,14,41,34.1
Joe Ingles,UTA,28,81,43,22.3%,28,65,43.1,49.2,12.0%,20,35,57.1,10.3%,8,30,26.7
Jodie Meeks,DET,28,3,2,25.0%,1,5,20,20,25.0%,1,5,20,0.0%,0,0,-
Joakim Noah,CHI,31,29,27,45.5%,23,60,38.3,38.3,45.5%,23,60,38.3,0.0%,0,0,-
Jimmy Butler,CHI,26,67,67,41.8%,214,432,49.5,51.2,37.7%,200,390,51.3,4.1%,14,42,33.3
Jimmer Fredette,SAS,27,6,1,20.0%,0,1,0,0,20.0%,0,1,0,0.0%,0,0,-
Jerryd Bayless,MIL,27,52,50,35.1%,66,153,43.1,51.6,20.9%,40,91,44,14.2%,26,62,41.9
Jerian Grant,NYK,23,76,60,36.6%,61,143,42.7,44.4,31.2%,56,122,45.9,5.4%,5,21,23.8
Jeremy Lin,CHA,27,78,76,37.0%,116,268,43.3,44.6,32.3%,109,234,46.6,4.7%,7,34,20.6
Jeremy Lamb,CHA,24,66,61,43.5%,113,222,50.9,54.1,35.3%,99,180,55,8.2%,14,42,33.3
Jeremy Evans,DAL,28,30,8,29.2%,10,14,71.4,71.4,27.1%,10,13,76.9,2.1%,0,1,0
Jerami Grant,PHI,22,77,67,34.3%,101,205,49.3,50.2,32.6%,97,195,49.7,1.7%,4,10,40
Jeff Withey,UTA,26,51,29,38.9%,32,63,50.8,50.8,38.9%,32,63,50.8,0.0%,0,0,-
Jeff Teague,ATL,28,79,78,35.0%,154,344,44.8,45.1,33.4%,152,328,46.3,1.6%,2,16,12.5
Jeff Green,LAC,29,80,74,35.4%,132,291,45.4,46.2,32.3%,127,266,47.7,3.0%,5,25,20
Jeff Ayres,LAC,29,17,4,30.4%,2,7,28.6,28.6,30.4%,2,7,28.6,0.0%,0,0,-
Jason Thompson,TOR,29,47,25,41.5%,25,44,56.8,56.8,40.6%,25,43,58.1,0.9%,0,1,0
Jason Terry,HOU,38,72,57,33.2%,54,124,43.5,52.8,15.0%,31,56,55.4,18.2%,23,68,33.8
Jason Smith,ORL,30,75,48,18.6%,38,91,41.8,42.3,18.4%,37,90,41.1,0.2%,1,1,100
Jarrett Jack,BKN,32,32,32,49.4%,69,176,39.2,42.3,38.2%,58,136,42.6,11.2%,11,40,27.5
Jarnell Stokes,MEM,22,7,2,40.0%,2,2,100,100,40.0%,2,2,100,0.0%,0,0,-
Jarell Martin,MEM,22,27,17,44.8%,20,52,38.5,38.5,44.0%,20,51,39.2,0.9%,0,1,0
Jarell Eddie,WAS,24,26,4,18.4%,1,7,14.3,21.4,7.9%,0,3,0,10.5%,1,4,25
Jared Sullinger,BOS,24,80,74,26.8%,108,214,50.5,50.5,26.3%,108,210,51.4,0.5%,0,4,0
Jared Dudley,WAS,30,81,48,18.3%,42,89,47.2,50.6,14.6%,36,71,50.7,3.7%,6,18,33.3
Jared Cunningham,CLE,25,44,17,30.8%,9,32,28.1,28.1,26.9%,9,28,32.1,3.8%,0,4,0
James Young,BOS,20,28,5,25.0%,3,9,33.3,38.9,13.9%,2,5,40,11.1%,1,4,25
James Michael McAdoo,GSW,23,41,17,40.5%,30,68,44.1,44.1,40.5%,30,68,44.1,0.0%,0,0,-
James Jones,CLE,35,48,24,30.0%,18,42,42.9,54.8,15.0%,8,21,38.1,15.0%,10,21,47.6
James Johnson,TOR,29,56,40,37.0%,45,87,51.7,52.3,34.9%,44,82,53.7,2.1%,1,5,20
James Harden,HOU,26,82,82,47.6%,364,768,47.4,53.9,31.3%,264,506,52.2,16.2%,100,262,38.2
James Ennis III,NOP,25,22,11,31.0%,18,35,51.4,54.3,26.5%,16,30,53.3,4.4%,2,5,40
James Anderson,SAC,27,50,25,28.6%,23,50,46,47,25.7%,22,45,48.9,2.9%,1,5,20
Jameer Nelson,DEN,34,39,33,32.9%,29,101,28.7,31.7,23.5%,23,72,31.9,9.4%,6,29,20.7
Jamal Crawford,LAC,36,79,78,47.3%,177,444,39.9,44.7,32.9%,134,309,43.4,14.4%,43,135,31.9
Jahlil Okafor,PHI,20,53,53,46.8%,186,363,51.2,51.2,46.6%,186,361,51.5,0.3%,0,2,0
Jae Crowder,BOS,25,72,71,33.7%,120,269,44.6,47.8,26.2%,103,209,49.3,7.5%,17,60,28.3
Jabari Parker,MIL,21,76,75,38.5%,185,345,53.6,53.8,38.2%,184,342,53.8,0.3%,1,3,33.3
JaVale McGee,DAL,28,34,29,43.3%,35,58,60.3,60.3,43.3%,35,58,60.3,0.0%,0,0,-
JaMychal Green,MEM,26,78,58,29.9%,75,147,51,51.7,29.3%,73,144,50.7,0.6%,2,3,66.7
JaKarr Sampson,DEN,23,73,60,42.9%,61,136,44.9,45.2,41.6%,60,132,45.5,1.3%,1,4,25
JR Smith,CLE,30,77,76,35.7%,112,302,37.1,43.5,21.0%,73,178,41,14.6%,39,124,31.5
JJ Redick,LAC,32,75,73,33.6%,139,295,47.1,54.7,22.5%,94,198,47.5,11.0%,45,97,46.4
JJ Hickson,WAS,27,35,25,47.7%,37,74,50,50,47.7%,37,74,50,0.0%,0,0,-
J.J. Barea,DAL,32,74,71,37.5%,124,265,46.8,48.7,31.7%,114,224,50.9,5.8%,10,41,24.4
Ish Smith,PHI,27,77,72,43.1%,162,416,38.9,40.3,39.4%,151,380,39.7,3.7%,11,36,30.6
Isaiah Thomas,BOS,27,81,81,44.0%,244,600,40.7,45.5,30.3%,186,413,45,13.7%,58,187,31
Isaiah Canaan,PHI,25,77,62,30.1%,75,218,34.4,42.9,14.8%,38,107,35.5,15.3%,37,111,33.3
Iman Shumpert,CLE,26,54,40,27.7%,32,84,38.1,39.3,21.8%,30,66,45.5,5.9%,2,18,11.1
Ian Mahinmi,IND,29,71,66,43.7%,135,195,69.2,69.2,43.7%,135,195,69.2,0.0%,0,0,-
Ian Clark,GSW,25,66,38,37.1%,35,75,46.7,50,32.2%,30,65,46.2,5.0%,5,10,50
Hollis Thompson,PHI,25,77,71,31.9%,76,215,35.3,39.1,20.1%,60,136,44.1,11.7%,16,79,20.3
Henry Sims,BKN,26,14,12,44.2%,15,34,44.1,44.1,44.2%,15,34,44.1,0.0%,0,0,-
Hassan Whiteside,MIA,27,73,73,43.8%,190,298,63.8,63.8,43.8%,190,298,63.8,0.0%,0,0,-
Harrison Barnes,GSW,24,66,64,27.2%,81,172,47.1,47.7,25.6%,79,162,48.8,1.6%,2,10,20
Greivis Vasquez,MIL,29,23,22,33.3%,18,46,39.1,40.2,24.6%,17,34,50,8.7%,1,12,8.3
Greg Smith,MIN,25,18,7,40.6%,8,13,61.5,61.5,40.6%,8,13,61.5,0.0%,0,0,-
Greg Monroe,MIL,26,79,79,41.3%,225,388,58,58,41.3%,225,388,58,0.0%,0,0,-
Gorgui Dieng,MIN,26,82,71,34.4%,109,199,54.8,55,34.3%,108,198,54.5,0.2%,1,1,100
Gordon Hayward,UTA,26,80,80,31.5%,165,379,43.5,46.2,26.5%,145,318,45.6,5.1%,20,61,32.8
Goran Dragic,MIA,30,72,70,35.3%,145,309,46.9,48.7,32.2%,134,282,47.5,3.1%,11,27,40.7
Glenn Robinson,IND,22,45,25,29.1%,21,44,47.7,51.1,24.5%,18,37,48.6,4.6%,3,7,42.9
Giannis Antetokounmpo,MIL,21,80,80,41.6%,240,420,57.1,57.4,40.9%,238,413,57.6,0.7%,2,7,28.6
Gerald Henderson,POR,28,72,65,34.7%,78,183,42.6,44,31.5%,73,166,44,3.2%,5,17,29.4
Gerald Green,MIA,30,69,61,38.9%,93,228,40.8,45.4,27.3%,72,160,45,11.6%,21,68,30.9
George Hill,IND,30,74,71,30.6%,94,226,41.6,44.2,25.1%,82,185,44.3,5.6%,12,41,29.3
Gary Neal,WAS,31,40,36,35.8%,50,116,43.1,44.4,30.9%,47,100,47,4.9%,3,16,18.8
Gary Harris,DEN,21,76,74,35.7%,138,273,50.5,52.9,30.1%,125,230,54.3,5.6%,13,43,30.2
Garrett Temple,WAS,30,80,57,23.2%,52,117,44.4,46.2,19.8%,48,100,48,3.4%,4,17,23.5
Frank Kaminsky,CHA,23,81,68,29.1%,73,153,47.7,48,28.8%,72,151,47.7,0.4%,1,2,50
Festus Ezeli,GSW,26,46,42,48.9%,59,111,53.2,53.2,48.9%,59,111,53.2,0.0%,0,0,-
Evan Turner,BOS,27,80,76,45.2%,157,337,46.6,46.9,44.1%,155,329,47.1,1.1%,2,8,25
Evan Fournier,ORL,23,78,77,28.7%,137,263,52.1,53.2,25.5%,131,234,56,3.2%,6,29,20.7
Ersan Ilyasova,ORL,29,74,70,32.4%,89,214,41.6,43.5,27.7%,81,183,44.3,4.7%,8,31,25.8
Erick Green,DEN,25,9,2,38.5%,1,5,20,20,23.1%,1,3,33.3,15.4%,0,2,0
Eric Moreland,SAC,24,7,2,33.3%,1,2,50,50,33.3%,1,2,50,0.0%,0,0,-
Eric Gordon,NOP,27,45,42,30.1%,60,166,36.1,38,26.0%,54,143,37.8,4.2%,6,23,26.1
Eric Bledsoe,PHX,26,31,31,35.2%,76,173,43.9,44.2,32.6%,75,160,46.9,2.6%,1,13,7.7
Enes Kanter,OKC,24,82,78,43.1%,197,307,64.2,64.2,42.8%,197,305,64.6,0.3%,0,2,0
Emmanuel Mudiay,DEN,20,68,67,38.4%,124,347,35.7,37.5,33.0%,112,298,37.6,5.4%,12,49,24.5
Elliot Williams,CHA,27,5,2,20.0%,0,2,0,0,20.0%,0,2,0,0.0%,0,0,-
Elijah Millsap,UTA,28,20,8,28.2%,1,11,9.1,9.1,23.1%,1,9,11.1,5.1%,0,2,0
Elfrid Payton,ORL,22,72,71,37.9%,123,273,45.1,45.2,36.3%,122,262,46.6,1.5%,1,11,9.1
Edy Tavares,ATL,24,11,6,63.2%,7,12,58.3,58.3,63.2%,7,12,58.3,0.0%,0,0,-
Ed Davis,POR,27,81,65,40.2%,82,133,61.7,61.7,40.2%,82,133,61.7,0.0%,0,0,-
E'Twaun Moore,CHI,27,59,51,39.1%,75,152,49.3,50.7,36.0%,71,140,50.7,3.1%,4,12,33.3
Dwyane Wade,MIA,34,74,74,51.2%,264,606,43.6,43.6,50.2%,263,594,44.3,1.0%,1,12,8.3
Dwight Powell,DAL,24,69,46,34.5%,59,102,57.8,57.8,33.8%,59,100,59,0.7%,0,2,0
Dwight Howard,HOU,30,71,69,52.0%,192,311,61.7,61.7,51.8%,192,310,61.9,0.2%,0,1,0
Duje Dukan,SAC,24,1,1,20.0%,0,2,0,0,20.0%,0,2,0,0.0%,0,0,-
Drew Gooden,WAS,34,30,17,25.2%,10,26,38.5,38.5,22.3%,10,23,43.5,2.9%,0,3,0
Draymond Green,GSW,26,81,75,32.8%,140,267,52.4,53.2,31.2%,136,254,53.5,1.6%,4,13,30.8
Doug McDermott,CHI,24,81,73,33.2%,101,213,47.4,50.2,27.0%,89,173,51.4,6.2%,12,40,30
Donatas Motiejunas,HOU,25,37,29,33.3%,29,68,42.6,42.6,33.3%,29,68,42.6,0.0%,0,0,-
Donald Sloan,BKN,28,61,52,37.8%,54,132,40.9,44.3,29.5%,45,103,43.7,8.3%,9,29,31
Dirk Nowitzki,DAL,38,75,75,44.3%,212,493,43,44.6,38.8%,196,431,45.5,5.6%,16,62,25.8
Dion Waiters,OKC,24,78,73,32.5%,97,229,42.4,44.8,27.1%,86,191,45,5.4%,11,38,28.9
Dewayne Dedmon,ORL,26,58,34,43.5%,45,77,58.4,58.4,43.5%,45,77,58.4,0.0%,0,0,-
Devyn Marble,ORL,23,28,13,31.0%,7,22,31.8,31.8,25.4%,7,18,38.9,5.6%,0,4,0
Devin Harris,DAL,33,64,55,33.9%,56,126,44.4,47.6,27.2%,48,101,47.5,6.7%,8,25,32
Devin Booker,PHX,19,76,68,41.8%,161,362,44.5,47,34.3%,143,297,48.1,7.5%,18,65,27.7
Derrick Williams,NYK,25,80,65,32.4%,99,183,54.1,56.6,27.8%,90,157,57.3,4.6%,9,26,34.6
Derrick Rose,CHI,27,66,65,44.6%,210,467,45,46.1,40.8%,199,427,46.6,3.8%,11,40,27.5
Derrick Favors,UTA,24,62,61,32.8%,155,266,58.3,58.3,32.6%,155,264,58.7,0.2%,0,2,0
Deron Williams,DAL,32,65,65,38.0%,112,294,38.1,41.5,29.4%,92,227,40.5,8.7%,20,67,29.9
Dennis Schroder,ATL,22,80,76,36.2%,131,282,46.5,47.9,34.1%,123,266,46.2,2.1%,8,16,50
Delon Wright,TOR,24,27,16,47.5%,18,38,47.4,47.4,45.0%,18,36,50,2.5%,0,2,0
DeMarre Carroll,TOR,29,26,26,40.7%,41,110,37.3,40.9,30.7%,33,83,39.8,10.0%,8,27,29.6
DeMarcus Cousins,SAC,25,64,63,35.4%,225,464,48.5,48.7,34.5%,223,452,49.3,0.9%,2,12,16.7
DeMar DeRozan,TOR,26,77,77,49.4%,294,670,43.9,45.1,46.2%,278,627,44.3,3.2%,16,43,37.2
DeJuan Blair,WAS,27,29,18,47.1%,13,32,40.6,40.6,47.1%,13,32,40.6,0.0%,0,0,-
DeAndre Jordan,LAC,27,77,75,47.4%,168,240,70,70,47.2%,168,239,70.3,0.2%,0,1,0
David West,SAS,35,78,60,22.8%,65,102,63.7,63.7,22.4%,65,100,65,0.4%,0,2,0
David Lee,DAL,33,54,50,54.2%,101,179,56.4,56.4,53.9%,101,178,56.7,0.3%,0,1,0
Darrun Hilliard,DET,23,38,24,36.6%,13,48,27.1,28.1,29.0%,12,38,31.6,7.6%,1,10,10
Darren Collison,SAC,28,73,72,34.8%,135,267,50.6,52.2,29.9%,126,229,55,5.0%,9,38,23.7
Darrell Arthur,DEN,28,70,49,25.2%,49,123,39.8,40.2,24.2%,48,118,40.7,1.0%,1,5,20
Dante Cunningham,NOP,29,80,63,29.4%,54,121,44.6,45.9,24.5%,51,101,50.5,4.9%,3,20,15
Danny Green,SAS,29,79,66,25.4%,56,142,39.4,44.4,17.5%,42,98,42.9,7.9%,14,44,31.8
Danilo Gallinari,DEN,27,53,53,38.3%,114,268,42.5,45,31.2%,101,218,46.3,7.2%,13,50,26
Damjan Rudez,MIN,30,33,12,24.2%,7,15,46.7,53.3,9.7%,5,6,83.3,14.5%,2,9,22.2
Damien Inglis,MIL,21,20,6,18.9%,4,7,57.1,57.1,18.9%,4,7,57.1,0.0%,0,0,-
Damian Lillard,POR,25,75,75,37.0%,209,544,38.4,42.9,25.6%,160,376,42.6,11.4%,49,168,29.2
Dahntay Jones,CLE,35,1,1,57.1%,4,8,50,50,57.1%,4,8,50,0.0%,0,0,-
D.J. Augustin,DEN,28,62,47,38.0%,53,133,39.8,44.4,26.9%,41,94,43.6,11.1%,12,39,30.8
D'Angelo Russell,LAL,20,80,79,38.8%,160,370,43.2,45,30.8%,147,294,50,8.0%,13,76,17.1
Cristiano Felicio,CHI,23,31,15,40.3%,16,29,55.2,55.2,38.9%,16,28,57.1,1.4%,0,1,0
Courtney Lee,CHA,30,79,74,29.6%,94,189,49.7,51.6,25.5%,87,163,53.4,4.1%,7,26,26.9
Cory Joseph,TOR,24,79,74,39.3%,99,225,44,44.4,37.5%,97,215,45.1,1.7%,2,10,20
Cory Jefferson,PHX,25,8,5,36.4%,4,8,50,50,36.4%,4,8,50,0.0%,0,0,-
Corey Brewer,HOU,30,82,70,39.6%,93,218,42.7,44,34.9%,87,192,45.3,4.7%,6,26,23.1
Cole Aldrich,LAC,27,60,45,50.7%,66,114,57.9,57.9,50.7%,66,114,57.9,0.0%,0,0,-
Cody Zeller,CHA,23,73,68,43.7%,121,191,63.4,63.4,43.7%,121,191,63.4,0.0%,0,0,-
Clint Capela,HOU,22,77,67,49.2%,116,195,59.5,59.5,49.0%,116,194,59.8,0.3%,0,1,0
Cliff Alexander,POR,20,8,4,70.0%,3,7,42.9,42.9,70.0%,3,7,42.9,0.0%,0,0,-
Cleanthony Early,NYK,25,17,7,27.5%,4,11,36.4,36.4,27.5%,4,11,36.4,0.0%,0,0,-
Christian Wood,PHI,20,17,8,32.1%,12,17,70.6,70.6,32.1%,12,17,70.6,0.0%,0,0,-
Chris Paul,LAC,31,74,74,34.2%,167,381,43.8,45.9,29.1%,151,324,46.6,5.1%,16,57,28.1
Chris McCullough,BKN,21,24,16,24.8%,13,27,48.1,48.1,23.9%,13,26,50,0.9%,0,1,0
Chris Kaman,POR,34,16,8,32.6%,7,14,50,50,30.2%,7,13,53.8,2.3%,0,1,0
Chris Johnson,UTA,26,70,40,33.7%,22,65,33.8,37.7,23.3%,17,45,37.8,10.4%,5,20,25
Chris Copeland,MIL,32,24,7,19.6%,4,10,40,45,9.8%,3,5,60,9.8%,1,5,20
Chris Bosh,MIA,32,53,53,32.5%,120,249,48.2,49.4,28.9%,114,222,51.4,3.5%,6,27,22.2
Chris Andersen,MEM,37,27,18,44.4%,21,32,65.6,65.6,44.4%,21,32,65.6,0.0%,0,0,-
Chase Budinger,PHX,28,66,42,30.5%,39,73,53.4,55.5,24.3%,36,58,62.1,6.3%,3,15,20
Charlie Villanueva,DAL,31,62,43,30.2%,48,99,48.5,52,24.1%,41,79,51.9,6.1%,7,20,35
Charles Hayes,LAC,33,2,1,50.0%,0,1,0,0,50.0%,0,1,0,0.0%,0,0,-
Channing Frye,CLE,33,69,40,22.4%,37,77,48.1,54.5,13.4%,27,46,58.7,9.0%,10,31,32.3
Chandler Parsons,DAL,27,61,60,41.3%,133,268,49.6,54.5,31.4%,107,204,52.5,9.9%,26,64,40.6
Caron Butler,SAC,36,16,9,35.6%,7,21,33.3,33.3,33.9%,7,20,35,1.7%,0,1,0
Carmelo Anthony,NYK,32,72,72,44.9%,254,587,43.3,45.9,37.9%,223,495,45.1,7.0%,31,92,33.7
Carl Landry,PHI,32,36,27,28.1%,46,70,65.7,65.7,28.1%,46,70,65.7,0.0%,0,0,-
Cameron Payne,OKC,21,57,43,35.7%,41,99,41.4,43.4,30.0%,37,83,44.6,5.8%,4,16,25
Cameron Bairstow,DET,25,18,8,30.0%,6,12,50,50,30.0%,6,12,50,0.0%,0,0,-
CJ Wilcox,LAC,25,23,11,25.8%,2,17,11.8,11.8,21.2%,2,14,14.3,4.5%,0,3,0
CJ Watson,ORL,32,33,25,38.0%,17,52,32.7,33.7,31.4%,16,43,37.2,6.6%,1,9,11.1
CJ Miles,IND,29,64,62,36.4%,97,230,42.2,50,19.8%,61,125,48.8,16.6%,36,105,34.3
CJ McCollum,POR,24,80,80,37.2%,227,531,42.7,46.3,29.2%,189,417,45.3,8.0%,38,114,33.3
Bryce Dejean-Jones,NOP,23,14,8,29.0%,7,20,35,45,18.8%,3,13,23.1,10.1%,4,7,57.1
Bryce Cotton,MEM,23,8,2,25.0%,1,2,50,50,25.0%,1,2,50,0.0%,0,0,-
Bruno Caboclo,TOR,20,6,2,16.7%,0,2,0,0,16.7%,0,2,0,0.0%,0,0,-
Brook Lopez,BKN,28,73,73,40.9%,244,472,51.7,51.7,40.9%,244,472,51.7,0.0%,0,0,-
Briante Weber,MIA,23,7,6,48.7%,7,19,36.8,36.8,46.2%,7,18,38.9,2.6%,0,1,0
Brian Roberts,POR,30,51,30,37.2%,29,61,47.5,51.6,32.3%,24,53,45.3,4.9%,5,8,62.5
Brandon Rush,GSW,30,72,35,20.8%,25,54,46.3,49.1,18.5%,22,48,45.8,2.3%,3,6,50
Brandon Knight,PHX,24,52,52,33.3%,147,298,49.3,53,26.8%,125,240,52.1,6.5%,22,58,37.9
Brandon Jennings,ORL,26,48,38,31.4%,37,95,38.9,47.9,18.8%,20,57,35.1,12.5%,17,38,44.7
Brandon Bass,LAL,31,66,56,42.3%,70,134,52.2,52.2,42.0%,70,133,52.6,0.3%,0,1,0
Branden Dawson,LAC,23,6,1,40.0%,1,2,50,50,40.0%,1,2,50,0.0%,0,0,-
Brandan Wright,MEM,28,12,12,42.3%,11,22,50,50,42.3%,11,22,50,0.0%,0,0,-
Bradley Beal,WAS,23,55,54,32.2%,121,257,47.1,48.8,28.6%,112,228,49.1,3.6%,9,29,31
Boris Diaw,SAS,34,76,57,29.5%,66,113,58.4,58.4,29.5%,66,113,58.4,0.0%,0,0,-
Bojan Bogdanovic,BKN,27,79,72,31.5%,103,235,43.8,46.8,25.0%,89,186,47.8,6.6%,14,49,28.6
Bobby Portis,CHI,21,62,52,33.6%,59,146,40.4,40.4,32.6%,59,142,41.5,0.9%,0,4,0
Boban Marjanovic,SAS,27,54,32,52.3%,51,91,56,56,52.3%,51,91,56,0.0%,0,0,-
Blake Griffin,LAC,27,35,34,23.1%,78,139,56.1,56.1,22.6%,78,136,57.4,0.5%,0,3,0
Bismack Biyombo,TOR,23,81,64,46.1%,79,130,60.8,60.8,45.7%,79,129,61.2,0.4%,0,1,0
Beno Udrih,MEM,33,44,36,36.0%,35,71,49.3,50.7,33.5%,33,66,50,2.5%,2,5,40
Ben McLemore,SAC,23,67,57,28.3%,55,127,43.3,45.7,24.1%,49,108,45.4,4.2%,6,19,31.6
Axel Toupane,DEN,23,21,9,24.3%,6,17,35.3,35.3,21.4%,6,15,40,2.9%,0,2,0
Avery Bradley,BOS,25,75,75,39.6%,181,397,45.6,49.2,30.3%,152,304,50,9.3%,29,93,31.2
Austin Rivers,LAC,23,67,61,32.6%,84,168,50,53,27.1%,74,140,52.9,5.4%,10,28,35.7
Arron Afflalo,NYK,30,71,69,53.6%,176,428,41.1,44.4,42.4%,148,338,43.8,11.3%,28,90,31.1
Aron Baynes,DET,29,81,72,40.9%,83,156,53.2,53.2,40.9%,83,156,53.2,0.0%,0,0,-
Archie Goodwin,PHX,21,57,45,39.0%,76,164,46.3,47.6,34.8%,72,146,49.3,4.3%,4,18,22.2
Anthony Tolliver,DET,31,72,26,12.7%,15,42,35.7,44,6.3%,8,21,38.1,6.3%,7,21,33.3
Anthony Morrow,OKC,30,68,46,30.6%,40,102,39.2,47.1,20.1%,24,67,35.8,10.5%,16,35,45.7
Anthony Davis,NOP,23,61,60,38.0%,226,431,52.4,52.7,37.4%,224,424,52.8,0.6%,2,7,28.6
Anthony Brown,LAL,23,29,18,22.4%,8,28,28.6,32.1,12.8%,6,16,37.5,9.6%,2,12,16.7
Anthony Bennett,TOR,23,19,7,34.6%,4,9,44.4,50,30.8%,3,8,37.5,3.8%,1,1,100
Andrew Wiggins,MIN,21,81,81,38.9%,233,503,46.3,46.5,37.6%,231,486,47.5,1.3%,2,17,11.8
Andrew Nicholson,ORL,26,55,37,33.9%,50,104,48.1,48.1,33.6%,50,103,48.5,0.3%,0,1,0
Andrew Goudelock,HOU,27,8,4,45.0%,6,9,66.7,72.2,35.0%,5,7,71.4,10.0%,1,2,50
Andrew Bogut,GSW,31,70,61,47.5%,78,131,59.5,59.5,47.5%,78,131,59.5,0.0%,0,0,-
Andrea Bargnani,BKN,30,46,33,26.0%,36,72,50,50,26.0%,36,72,50,0.0%,0,0,-
Andre Roberson,OKC,24,70,49,34.1%,54,93,58.1,59.1,33.3%,52,91,57.1,0.7%,2,2,100
Andre Miller,SAS,40,39,20,36.8%,22,39,56.4,56.4,36.8%,22,39,56.4,0.0%,0,0,-
Andre Iguodala,GSW,32,65,52,30.4%,49,111,44.1,46.4,24.4%,44,89,49.4,6.0%,5,22,22.7
Andre Drummond,DET,22,81,81,55.0%,312,581,53.7,53.9,54.8%,310,579,53.5,0.2%,2,2,100
Anderson Varejao,GSW,33,53,28,34.7%,14,43,32.6,32.6,34.7%,14,43,32.6,0.0%,0,0,-
Amir Johnson,BOS,29,78,66,44.5%,120,188,63.8,63.8,44.3%,120,187,64.2,0.2%,0,1,0
Amar'e Stoudemire,MIA,33,52,39,42.1%,54,93,58.1,58.1,42.1%,54,93,58.1,0.0%,0,0,-
Alonzo Gee,NOP,29,73,46,33.5%,46,85,54.1,54.1,31.1%,46,79,58.2,2.4%,0,6,0
Allen Crabbe,POR,24,81,75,34.9%,101,235,43,45.1,28.8%,91,194,46.9,6.1%,10,41,24.4
Alexis Ajinca,NOP,28,59,42,39.8%,62,125,49.6,49.6,39.8%,62,125,49.6,0.0%,0,0,-
Alex Len,PHX,23,78,68,37.0%,113,229,49.3,49.3,36.8%,113,228,49.6,0.2%,0,1,0
Alec Burks,UTA,24,31,30,34.7%,43,116,37.1,38.4,32.0%,40,107,37.4,2.7%,3,9,33.3
Alan Williams,PHX,23,10,7,45.8%,4,11,36.4,36.4,45.8%,4,11,36.4,0.0%,0,0,-
Alan Anderson,WAS,33,13,11,54.2%,10,32,31.3,37.5,27.1%,6,16,37.5,27.1%,4,16,25
Al-Farouq Aminu,POR,25,82,63,23.3%,72,167,43.1,46.4,19.2%,61,138,44.2,4.0%,11,29,37.9
Al Jefferson,CHA,31,47,46,45.9%,98,232,42.2,42.2,45.9%,98,232,42.2,0.0%,0,0,-
Al Horford,ATL,30,82,79,26.4%,155,277,56,56.3,25.9%,153,271,56.5,0.6%,2,6,33.3
Adreian Payne,MIN,25,52,28,31.9%,19,46,41.3,43.5,27.8%,17,40,42.5,4.2%,2,6,33.3
Aaron Harrison,CHA,21,21,5,36.8%,1,7,14.3,14.3,26.3%,1,5,20,10.5%,0,2,0
Aaron Gordon,ORL,20,77,68,35.5%,110,205,53.7,53.7,33.8%,110,195,56.4,1.7%,0,10,0
