PLAYER,TEAM,AGE,GP,G,FREQ,FGM,FGA,FG%,EFG%,2FG FREQ,2FGM,2FGA,2FG%,3FG FREQ,3PM,3PA,3P%
Aaron Brooks,CHI,31,69,53,27.9%,41,131,31.3,40.8,10.2%,16,48,33.3,17.7%,25,83,30.1
Aaron Gordon,ORL,20,77,58,19.8%,52,114,45.6,50.9,14.2%,40,82,48.8,5.5%,12,32,37.5
Aaron Harrison,CHA,21,21,3,21.1%,3,4,75,100,10.5%,1,2,50,10.5%,2,2,100
Adreian Payne,MIN,25,52,27,29.2%,14,42,33.3,36.9,20.1%,11,29,37.9,9.0%,3,13,23.1
Al Horford,ATL,30,82,78,24.4%,139,256,54.3,55.9,21.7%,131,227,57.7,2.8%,8,29,27.6
Al Jefferson,CHA,31,47,41,23.2%,69,117,59,59,23.2%,69,117,59,0.0%,0,0,-
Al-Farouq Aminu,POR,25,82,71,25.3%,90,182,49.5,62.1,10.7%,44,77,57.1,14.6%,46,105,43.8
Alan Anderson,WAS,33,13,12,33.9%,8,20,40,57.5,3.4%,1,2,50,30.5%,7,18,38.9
Alan Williams,PHX,23,10,2,8.3%,1,2,50,50,8.3%,1,2,50,0.0%,0,0,-
Alec Burks,UTA,24,31,28,22.8%,27,76,35.5,42.1,14.4%,17,48,35.4,8.4%,10,28,35.7
Alex Len,PHX,23,78,57,18.3%,42,113,37.2,37.2,17.9%,42,111,37.8,0.3%,0,2,0
Alexis Ajinca,NOP,28,59,38,24.2%,32,76,42.1,42.1,23.9%,32,75,42.7,0.3%,0,1,0
Allen Crabbe,POR,24,81,76,30.4%,93,205,45.4,55.9,13.1%,50,88,56.8,17.4%,43,117,36.8
Alonzo Gee,NOP,29,73,37,20.9%,31,53,58.5,64.2,13.4%,25,34,73.5,7.5%,6,19,31.6
Amar'e Stoudemire,MIA,33,52,28,17.2%,25,38,65.8,65.8,17.2%,25,38,65.8,0.0%,0,0,-
Amir Johnson,BOS,29,78,45,15.2%,37,64,57.8,61.7,10.7%,32,45,71.1,4.5%,5,19,26.3
Anderson Varejao,GSW,33,53,18,20.2%,11,25,44,44,20.2%,11,25,44,0.0%,0,0,-
Andre Drummond,DET,22,81,56,9.2%,63,97,64.9,64.9,9.0%,63,95,66.3,0.2%,0,2,0
Andre Iguodala,GSW,32,65,55,36.4%,64,133,48.1,56.4,16.4%,42,60,70,20.0%,22,73,30.1
Andre Miller,SAS,40,39,9,17.9%,13,19,68.4,71.1,15.1%,12,16,75,2.8%,1,3,33.3
Andre Roberson,OKC,24,70,33,15.4%,26,42,61.9,65.5,9.2%,23,25,92,6.2%,3,17,17.6
Andrea Bargnani,BKN,30,46,37,32.5%,40,90,44.4,45,30.0%,39,83,47,2.5%,1,7,14.3
Andrew Bogut,GSW,31,70,33,21.4%,41,59,69.5,70.3,21.0%,40,58,69,0.4%,1,1,100
Andrew Goudelock,HOU,27,8,1,10.0%,1,2,50,50,5.0%,1,1,100,5.0%,0,1,0
Andrew Nicholson,ORL,26,55,31,15.0%,20,46,43.5,48.9,8.1%,15,25,60,6.8%,5,21,23.8
Andrew Wiggins,MIN,21,81,78,21.5%,122,278,43.9,48.9,14.5%,94,187,50.3,7.0%,28,91,30.8
Anthony Bennett,TOR,23,19,4,19.2%,1,5,20,20,7.7%,1,2,50,11.5%,0,3,0
Anthony Brown,LAL,23,29,23,41.6%,15,52,28.8,39.4,12.0%,4,15,26.7,29.6%,11,37,29.7
Anthony Davis,NOP,23,61,61,28.4%,141,322,43.8,45.5,24.4%,130,277,46.9,4.0%,11,45,24.4
Anthony Morrow,OKC,30,68,54,37.5%,50,125,40,53.6,9.0%,16,30,53.3,28.5%,34,95,35.8
Anthony Tolliver,DET,31,72,56,44.7%,50,148,33.8,47.3,5.7%,10,19,52.6,39.0%,40,129,31
Archie Goodwin,PHX,21,57,37,20.5%,35,86,40.7,47.7,10.0%,23,42,54.8,10.5%,12,44,27.3
Aron Baynes,DET,29,81,39,13.9%,35,53,66,66,13.6%,35,52,67.3,0.3%,0,1,0
Arron Afflalo,NYK,30,71,67,24.8%,95,198,48,57.6,13.7%,57,109,52.3,11.2%,38,89,42.7
Austin Rivers,LAC,23,67,59,30.8%,59,159,37.1,44.7,13.6%,35,70,50,17.2%,24,89,27
Avery Bradley,BOS,25,75,75,31.4%,130,315,41.3,50.8,14.6%,70,146,47.9,16.8%,60,169,35.5
Axel Toupane,DEN,23,21,20,45.7%,5,32,15.6,17.2,17.1%,4,12,33.3,28.6%,1,20,5
Ben McLemore,SAC,23,67,60,31.8%,57,143,39.9,47.9,16.3%,34,73,46.6,15.6%,23,70,32.9
Beno Udrih,MEM,33,44,35,26.4%,27,52,51.9,58.7,19.3%,20,38,52.6,7.1%,7,14,50
Bismack Biyombo,TOR,23,81,36,17.0%,27,48,56.3,56.3,17.0%,27,48,56.3,0.0%,0,0,-
Blake Griffin,LAC,27,35,35,29.2%,77,176,43.8,44.3,28.2%,75,170,44.1,1.0%,2,6,33.3
Boban Marjanovic,SAS,27,54,11,7.5%,6,13,46.2,46.2,7.5%,6,13,46.2,0.0%,0,0,-
Bobby Portis,CHI,21,62,48,22.3%,47,97,48.5,50,18.9%,44,82,53.7,3.4%,3,15,20
Bojan Bogdanovic,BKN,27,79,73,26.6%,81,198,40.9,53.8,7.9%,30,59,50.8,18.7%,51,139,36.7
Boris Diaw,SAS,34,76,43,15.7%,24,60,40,42.5,12.3%,21,47,44.7,3.4%,3,13,23.1
Bradley Beal,WAS,23,55,55,32.7%,117,261,44.8,53.4,18.0%,72,144,50,14.7%,45,117,38.5
Brandan Wright,MEM,28,12,8,17.3%,6,9,66.7,66.7,17.3%,6,9,66.7,0.0%,0,0,-
Branden Dawson,LAC,23,6,1,40.0%,1,2,50,50,40.0%,1,2,50,0.0%,0,0,-
Brandon Bass,LAL,31,66,44,20.2%,34,64,53.1,53.1,19.9%,34,63,54,0.3%,0,1,0
Brandon Jennings,ORL,26,48,48,40.9%,36,124,29,36.7,16.2%,17,49,34.7,24.8%,19,75,25.3
Brandon Knight,PHX,24,52,52,35.1%,112,314,35.7,43.2,17.0%,65,152,42.8,18.1%,47,162,29
Brandon Rush,GSW,30,72,36,20.8%,19,54,35.2,44.4,8.5%,9,22,40.9,12.3%,10,32,31.3
Brian Roberts,POR,30,51,29,35.4%,21,58,36.2,39.7,23.8%,17,39,43.6,11.6%,4,19,21.1
Briante Weber,MIA,23,7,3,17.9%,4,7,57.1,57.1,17.9%,4,7,57.1,0.0%,0,0,-
Brook Lopez,BKN,28,73,68,22.9%,133,264,50.4,50.6,22.4%,132,258,51.2,0.5%,1,6,16.7
Bruno Caboclo,TOR,20,6,2,50.0%,1,6,16.7,25,8.3%,0,1,0,41.7%,1,5,20
Bryce Cotton,MEM,23,8,1,25.0%,1,2,50,50,12.5%,1,1,100,12.5%,0,1,0
Bryce Dejean-Jones,NOP,23,14,11,37.7%,12,26,46.2,57.7,15.9%,6,11,54.5,21.7%,6,15,40
CJ McCollum,POR,24,80,80,32.5%,217,464,46.8,55.6,18.2%,135,259,52.1,14.4%,82,205,40
CJ Miles,IND,29,64,62,29.9%,78,189,41.3,57.4,5.4%,17,34,50,24.5%,61,155,39.4
CJ Watson,ORL,32,33,24,31.4%,13,43,30.2,38.4,16.8%,6,23,26.1,14.6%,7,20,35
CJ Wilcox,LAC,25,23,12,45.5%,15,30,50,60,25.8%,9,17,52.9,19.7%,6,13,46.2
Cameron Bairstow,DET,25,18,8,27.5%,1,11,9.1,9.1,22.5%,1,9,11.1,5.0%,0,2,0
Cameron Payne,OKC,21,57,39,30.3%,31,84,36.9,45.2,12.3%,17,34,50,18.1%,14,50,28
Carl Landry,PHI,32,36,30,31.7%,40,79,50.6,51.9,30.9%,38,77,49.4,0.8%,2,2,100
Carmelo Anthony,NYK,32,72,72,29.7%,169,388,43.6,49.5,17.9%,123,234,52.6,11.8%,46,154,29.9
Caron Butler,SAC,36,16,8,37.3%,12,22,54.5,61.4,20.3%,9,12,75,16.9%,3,10,30
Chandler Parsons,DAL,27,61,59,32.4%,103,210,49,61,12.9%,53,84,63.1,19.4%,50,126,39.7
Channing Frye,CLE,33,69,56,31.7%,42,109,38.5,52.3,6.4%,12,22,54.5,25.3%,30,87,34.5
Charles Hayes,LAC,33,2,1,50.0%,1,1,100,100,50.0%,1,1,100,0.0%,0,0,-
Charlie Villanueva,DAL,31,62,40,26.2%,28,86,32.6,43.6,6.4%,9,21,42.9,19.8%,19,65,29.2
Chase Budinger,PHX,28,66,47,31.8%,26,76,34.2,42.8,11.7%,13,28,46.4,20.1%,13,48,27.1
Chris Andersen,MEM,37,27,8,13.9%,5,10,50,55,11.1%,4,8,50,2.8%,1,2,50
Chris Bosh,MIA,32,53,53,33.8%,112,259,43.2,49.2,22.2%,81,170,47.6,11.6%,31,89,34.8
Chris Copeland,MIL,32,24,10,41.2%,5,21,23.8,31,9.8%,2,5,40,31.4%,3,16,18.8
Chris Johnson,UTA,26,70,32,24.9%,18,48,37.5,45.8,9.3%,10,18,55.6,15.5%,8,30,26.7
Chris Kaman,POR,34,16,9,37.2%,7,16,43.8,46.9,32.6%,6,14,42.9,4.7%,1,2,50
Chris McCullough,BKN,21,24,20,31.2%,15,34,44.1,52.9,18.3%,9,20,45,12.8%,6,14,42.9
Chris Paul,LAC,31,74,74,41.7%,223,464,48.1,55.1,26.5%,158,295,53.6,15.2%,65,169,38.5
Christian Wood,PHI,20,17,7,17.0%,2,9,22.2,27.8,15.1%,1,8,12.5,1.9%,1,1,100
Cleanthony Early,NYK,25,17,6,30.0%,5,12,41.7,54.2,15.0%,2,6,33.3,15.0%,3,6,50
Cliff Alexander,POR,20,8,1,10.0%,1,1,100,100,10.0%,1,1,100,0.0%,0,0,-
Clint Capela,HOU,22,77,31,10.6%,32,42,76.2,76.2,10.6%,32,42,76.2,0.0%,0,0,-
Cody Zeller,CHA,23,73,36,14.4%,36,63,57.1,57.1,14.0%,36,61,59,0.5%,0,2,0
Cole Aldrich,LAC,27,60,21,11.6%,17,26,65.4,65.4,11.6%,17,26,65.4,0.0%,0,0,-
Corey Brewer,HOU,30,82,64,22.9%,45,126,35.7,43.3,8.9%,26,49,53.1,14.0%,19,77,24.7
Cory Jefferson,PHX,25,8,2,13.6%,0,3,0,0,13.6%,0,3,0,0.0%,0,0,-
Cory Joseph,TOR,24,79,76,27.6%,68,158,43,49.1,18.0%,49,103,47.6,9.6%,19,55,34.5
Coty Clarke,BOS,23,3,1,25.0%,1,1,100,150,0.0%,0,0,-,25.0%,1,1,100
Courtney Lee,CHA,30,79,74,34.6%,95,221,43,51.8,19.4%,56,124,45.2,15.2%,39,97,40.2
Cristiano Felicio,CHI,23,31,8,13.9%,7,10,70,70,13.9%,7,10,70,0.0%,0,0,-
D'Angelo Russell,LAL,20,80,80,32.1%,124,306,40.5,52.1,13.7%,53,131,40.5,18.3%,71,175,40.6
D.J. Augustin,DEN,28,62,45,31.4%,49,110,44.5,58.6,11.1%,18,39,46.2,20.3%,31,71,43.7
Dahntay Jones,CLE,35,1,1,21.4%,1,3,33.3,50,14.3%,0,2,0,7.1%,1,1,100
Damian Lillard,POR,25,75,75,34.8%,223,512,43.6,54.7,14.3%,109,211,51.7,20.5%,114,301,37.9
Damien Inglis,MIL,21,20,9,43.2%,4,16,25,31.3,21.6%,2,8,25,21.6%,2,8,25
Damjan Rudez,MIN,30,33,15,45.2%,12,28,42.9,58.9,4.8%,3,3,100,40.3%,9,25,36
Danilo Gallinari,DEN,27,53,53,36.3%,107,254,42.1,52.2,18.7%,56,131,42.7,17.6%,51,123,41.5
Danny Green,SAS,29,79,71,30.9%,61,173,35.3,46.2,8.6%,23,48,47.9,22.4%,38,125,30.4
Dante Cunningham,NOP,29,80,50,24.5%,41,101,40.6,48,11.2%,26,46,56.5,13.3%,15,55,27.3
Darrell Arthur,DEN,28,70,62,33.8%,86,165,52.1,56.7,25.6%,71,125,56.8,8.2%,15,40,37.5
Darren Collison,SAC,28,73,71,29.7%,114,228,50,58.1,18.6%,77,143,53.8,11.1%,37,85,43.5
Darrun Hilliard,DET,23,38,21,30.5%,18,40,45,56.3,15.3%,9,20,45,15.3%,9,20,45
David Lee,DAL,33,54,30,12.1%,23,40,57.5,57.5,12.1%,23,40,57.5,0.0%,0,0,-
David West,SAS,35,78,62,28.0%,65,125,52,52.8,27.3%,63,122,51.6,0.7%,2,3,66.7
DeAndre Jordan,LAC,27,77,48,14.0%,60,71,84.5,84.5,14.0%,60,71,84.5,0.0%,0,0,-
DeJuan Blair,WAS,27,29,15,32.4%,10,22,45.5,45.5,32.4%,10,22,45.5,0.0%,0,0,-
DeMar DeRozan,TOR,26,77,77,22.8%,134,310,43.2,46,18.6%,117,253,46.2,4.2%,17,57,29.8
DeMarcus Cousins,SAC,25,64,60,17.6%,94,231,40.7,45,13.3%,74,175,42.3,4.3%,20,56,35.7
DeMarre Carroll,TOR,29,26,23,27.0%,28,73,38.4,51.4,7.0%,9,19,47.4,20.0%,19,54,35.2
Delon Wright,TOR,24,27,10,21.3%,8,17,47.1,52.9,17.5%,6,14,42.9,3.8%,2,3,66.7
Dennis Schroder,ATL,22,80,74,29.1%,92,227,40.5,48.5,15.1%,56,118,47.5,14.0%,36,109,33
Deron Williams,DAL,32,65,62,32.3%,109,250,43.6,52.2,16.0%,66,124,53.2,16.3%,43,126,34.1
Derrick Favors,UTA,24,62,61,26.5%,97,215,45.1,45.1,26.4%,97,214,45.3,0.1%,0,1,0
Derrick Rose,CHI,27,66,61,30.5%,140,319,43.9,47.2,22.8%,119,238,50,7.7%,21,81,25.9
Derrick Williams,NYK,25,80,68,30.6%,76,173,43.9,48,20.5%,62,116,53.4,10.1%,14,57,24.6
Devin Booker,PHX,19,76,65,26.8%,101,232,43.5,52.6,12.9%,59,112,52.7,13.8%,42,120,35
Devin Harris,DAL,33,64,45,30.9%,45,115,39.1,47.4,13.4%,26,50,52,17.5%,19,65,29.2
Devyn Marble,ORL,23,28,13,39.4%,9,28,32.1,42.9,14.1%,3,10,30,25.4%,6,18,33.3
Dewayne Dedmon,ORL,26,58,16,14.1%,17,25,68,68,14.1%,17,25,68,0.0%,0,0,-
Dion Waiters,OKC,24,78,72,35.9%,106,253,41.9,50.6,20.6%,62,145,42.8,15.3%,44,108,40.7
Dirk Nowitzki,DAL,38,75,73,28.1%,139,312,44.6,52.4,16.0%,90,178,50.6,12.1%,49,134,36.6
Donald Sloan,BKN,28,61,44,26.6%,43,93,46.2,55.9,14.3%,25,50,50,12.3%,18,43,41.9
Donatas Motiejunas,HOU,25,37,24,25.5%,26,52,50,52.9,17.2%,23,35,65.7,8.3%,3,17,17.6
Doug McDermott,CHI,24,81,73,32.0%,94,205,45.9,59.8,12.6%,37,81,45.7,19.3%,57,124,46
Draymond Green,GSW,26,81,72,21.3%,86,174,49.4,60.1,9.7%,49,79,62,11.7%,37,95,38.9
Drew Gooden,WAS,34,30,19,30.1%,9,31,29,35.5,14.6%,5,15,33.3,15.5%,4,16,25
Duje Dukan,SAC,24,1,1,50.0%,1,5,20,30,20.0%,0,2,0,30.0%,1,3,33.3
Dwight Howard,HOU,30,71,34,9.2%,46,55,83.6,83.6,9.2%,46,55,83.6,0.0%,0,0,-
Dwight Powell,DAL,24,69,41,26.7%,42,79,53.2,53.2,25.0%,42,74,56.8,1.7%,0,5,0
Dwyane Wade,MIA,34,74,73,25.8%,137,305,44.9,45.2,23.9%,135,283,47.7,1.9%,2,22,9.1
E'Twaun Moore,CHI,27,59,44,30.1%,53,117,45.3,54.3,16.7%,32,65,49.2,13.4%,21,52,40.4
Ed Davis,POR,27,81,20,6.6%,17,22,77.3,77.3,6.6%,17,22,77.3,0.0%,0,0,-
Edy Tavares,ATL,24,11,4,26.3%,4,5,80,80,26.3%,4,5,80,0.0%,0,0,-
Elfrid Payton,ORL,22,72,59,21.9%,64,158,40.5,42.7,18.0%,57,130,43.8,3.9%,7,28,25
Elijah Millsap,UTA,28,20,2,5.1%,0,2,0,0,2.6%,0,1,0,2.6%,0,1,0
Elliot Williams,CHA,27,5,4,60.0%,1,6,16.7,16.7,30.0%,1,3,33.3,30.0%,0,3,0
Emmanuel Mudiay,DEN,20,68,67,30.7%,104,277,37.5,43.7,19.9%,70,180,38.9,10.7%,34,97,35.1
Enes Kanter,OKC,24,82,59,15.4%,63,110,57.3,58.2,15.0%,61,107,57,0.4%,2,3,66.7
Eric Bledsoe,PHX,26,31,30,31.2%,67,153,43.8,50.3,20.8%,47,102,46.1,10.4%,20,51,39.2
Eric Gordon,NOP,27,45,43,33.2%,72,183,39.3,51.1,10.0%,29,55,52.7,23.2%,43,128,33.6
Eric Moreland,SAC,24,7,1,16.7%,1,1,100,100,16.7%,1,1,100,0.0%,0,0,-
Erick Green,DEN,25,9,4,38.5%,2,5,40,40,30.8%,2,4,50,7.7%,0,1,0
Ersan Ilyasova,ORL,29,74,69,30.8%,78,203,38.4,46.6,13.3%,45,88,51.1,17.4%,33,115,28.7
Evan Fournier,ORL,23,78,74,26.2%,95,240,39.6,49.8,11.2%,46,103,44.7,15.0%,49,137,35.8
Evan Turner,BOS,27,80,72,26.4%,88,197,44.7,46.7,22.1%,80,165,48.5,4.3%,8,32,25
Festus Ezeli,GSW,26,46,21,14.1%,23,32,71.9,71.9,14.1%,23,32,71.9,0.0%,0,0,-
Frank Kaminsky,CHA,23,81,49,14.9%,28,78,35.9,42.3,6.9%,18,36,50,8.0%,10,42,23.8
Garrett Temple,WAS,30,80,64,30.9%,57,156,36.5,46.2,11.1%,27,56,48.2,19.8%,30,100,30
Gary Harris,DEN,21,76,74,30.5%,111,233,47.6,59.9,11.6%,54,89,60.7,18.8%,57,144,39.6
Gary Neal,WAS,31,40,37,37.3%,59,121,48.8,59.5,21.6%,33,70,47.1,15.7%,26,51,51
George Hill,IND,30,74,74,31.7%,103,234,44,55.3,13.4%,50,99,50.5,18.3%,53,135,39.3
Gerald Green,MIA,30,69,60,32.1%,73,188,38.8,47.9,16.0%,39,94,41.5,16.0%,34,94,36.2
Gerald Henderson,POR,28,72,68,32.8%,84,173,48.6,54.9,23.0%,62,121,51.2,9.9%,22,52,42.3
Giannis Antetokounmpo,MIL,21,80,73,21.0%,106,212,50,52.1,17.8%,97,180,53.9,3.2%,9,32,28.1
Glenn Robinson,IND,22,45,27,32.5%,16,49,32.7,35.7,21.9%,13,33,39.4,10.6%,3,16,18.8
Goran Dragic,MIA,30,72,69,31.3%,125,274,45.6,52,18.3%,90,160,56.3,13.0%,35,114,30.7
Gordon Hayward,UTA,26,80,80,32.2%,156,387,40.3,47.7,17.1%,99,205,48.3,15.1%,57,182,31.3
Gorgui Dieng,MIN,26,82,67,23.9%,78,138,56.5,56.9,22.7%,77,131,58.8,1.2%,1,7,14.3
Greg Monroe,MIL,26,79,60,11.1%,55,104,52.9,52.9,11.1%,55,104,52.9,0.0%,0,0,-
Greg Smith,MIN,25,18,2,6.3%,1,2,50,50,6.3%,1,2,50,0.0%,0,0,-
Greivis Vasquez,MIL,29,23,20,31.9%,9,44,20.5,27.3,8.7%,3,12,25,23.2%,6,32,18.8
Harrison Barnes,GSW,24,66,61,28.3%,84,179,46.9,53.1,18.0%,62,114,54.4,10.3%,22,65,33.8
Hassan Whiteside,MIA,27,73,58,19.4%,88,132,66.7,66.7,19.4%,88,132,66.7,0.0%,0,0,-
Henry Sims,BKN,26,14,8,26.0%,8,20,40,40,26.0%,8,20,40,0.0%,0,0,-
Hollis Thompson,PHI,25,77,73,37.0%,98,250,39.2,54.4,9.3%,22,63,34.9,27.7%,76,187,40.6
Ian Clark,GSW,25,66,31,24.8%,17,50,34,40,10.9%,11,22,50,13.9%,6,28,21.4
Ian Mahinmi,IND,29,71,39,13.5%,32,60,53.3,53.3,13.5%,32,60,53.3,0.0%,0,0,-
Iman Shumpert,CLE,26,54,43,34.3%,33,104,31.7,39.9,14.5%,16,44,36.4,19.8%,17,60,28.3
Isaiah Canaan,PHI,25,77,64,38.1%,104,276,37.7,52.9,6.4%,20,46,43.5,31.8%,84,230,36.5
Isaiah Thomas,BOS,27,81,81,27.3%,168,372,45.2,54.7,13.8%,97,188,51.6,13.5%,71,184,38.6
Ish Smith,PHI,27,77,68,26.6%,101,257,39.3,42.8,21.3%,83,206,40.3,5.3%,18,51,35.3
J.J. Barea,DAL,32,74,68,31.5%,97,223,43.5,53.6,13.7%,52,97,53.6,17.8%,45,126,35.7
JJ Hickson,WAS,27,35,17,15.5%,11,24,45.8,45.8,15.5%,11,24,45.8,0.0%,0,0,-
JJ Redick,LAC,32,75,74,36.3%,148,319,46.4,58.9,17.0%,68,149,45.6,19.3%,80,170,47.1
JR Smith,CLE,30,77,69,32.1%,118,272,43.4,58.6,9.2%,35,78,44.9,22.9%,83,194,42.8
JaKarr Sampson,DEN,23,73,39,19.9%,24,63,38.1,41.3,11.7%,20,37,54.1,8.2%,4,26,15.4
JaMychal Green,MEM,26,78,54,24.6%,48,121,39.7,41.3,21.1%,44,104,42.3,3.5%,4,17,23.5
JaVale McGee,DAL,28,34,13,17.2%,13,23,56.5,56.5,17.2%,13,23,56.5,0.0%,0,0,-
Jabari Parker,MIL,21,76,71,24.8%,101,222,45.5,46.4,23.1%,97,207,46.9,1.7%,4,15,26.7
Jae Crowder,BOS,25,72,71,41.8%,131,334,39.2,48.8,16.5%,67,132,50.8,25.3%,64,202,31.7
Jahlil Okafor,PHI,20,53,50,21.5%,65,167,38.9,38.9,21.4%,65,166,39.2,0.1%,0,1,0
Jamal Crawford,LAC,36,79,75,28.9%,110,271,40.6,49.4,14.9%,62,140,44.3,14.0%,48,131,36.6
Jameer Nelson,DEN,34,39,39,45.3%,56,139,40.3,50.4,18.6%,28,57,49.1,26.7%,28,82,34.1
James Anderson,SAC,27,50,30,34.3%,20,60,33.3,40,12.6%,12,22,54.5,21.7%,8,38,21.1
James Ennis III,NOP,25,22,11,29.2%,20,33,60.6,81.8,8.8%,6,10,60,20.4%,14,23,60.9
James Harden,HOU,26,82,82,30.1%,186,486,38.3,47.8,12.6%,93,203,45.8,17.5%,93,283,32.9
James Johnson,TOR,29,56,31,19.1%,15,45,33.3,40,8.1%,9,19,47.4,11.1%,6,26,23.1
James Jones,CLE,35,48,27,38.6%,21,54,38.9,56.5,5.0%,2,7,28.6,33.6%,19,47,40.4
James Michael McAdoo,GSW,23,41,13,15.5%,22,26,84.6,84.6,14.3%,22,24,91.7,1.2%,0,2,0
James Young,BOS,20,28,12,47.2%,4,17,23.5,35.3,0.0%,0,0,-,47.2%,4,17,23.5
Jared Cunningham,CLE,25,44,20,29.8%,12,31,38.7,46.8,15.4%,7,16,43.8,14.4%,5,15,33.3
Jared Dudley,WAS,30,81,73,36.3%,76,177,42.9,51.1,19.3%,47,94,50,17.0%,29,83,34.9
Jared Sullinger,BOS,24,80,73,25.4%,90,203,44.3,45.8,22.7%,84,181,46.4,2.8%,6,22,27.3
Jarell Eddie,WAS,24,26,9,39.5%,4,15,26.7,40,2.6%,0,1,0,36.8%,4,14,28.6
Jarell Martin,MEM,22,27,14,16.4%,8,19,42.1,42.1,16.4%,8,19,42.1,0.0%,0,0,-
Jarnell Stokes,MEM,22,7,1,20.0%,1,1,100,100,20.0%,1,1,100,0.0%,0,0,-
Jarrett Jack,BKN,32,32,31,28.7%,41,102,40.2,45.6,18.3%,30,65,46.2,10.4%,11,37,29.7
Jason Smith,ORL,30,75,71,42.2%,104,206,50.5,50.7,41.0%,103,200,51.5,1.2%,1,6,16.7
Jason Terry,HOU,38,72,55,32.4%,43,121,35.5,49.2,7.0%,10,26,38.5,25.5%,33,95,34.7
Jason Thompson,TOR,29,47,12,17.0%,9,18,50,55.6,12.3%,7,13,53.8,4.7%,2,5,40
Jeff Ayres,LAC,29,17,2,17.4%,3,4,75,75,17.4%,3,4,75,0.0%,0,0,-
Jeff Green,LAC,29,80,73,23.0%,82,189,43.4,48.4,14.8%,63,122,51.6,8.1%,19,67,28.4
Jeff Teague,ATL,28,79,74,24.9%,97,245,39.6,45.7,15.8%,67,155,43.2,9.2%,30,90,33.3
Jeff Withey,UTA,26,51,20,17.3%,18,28,64.3,64.3,17.3%,18,28,64.3,0.0%,0,0,-
Jerami Grant,PHI,22,77,57,16.4%,40,98,40.8,45.9,8.9%,30,53,56.6,7.5%,10,45,22.2
Jeremy Evans,DAL,28,30,9,25.0%,2,12,16.7,20.8,6.3%,1,3,33.3,18.8%,1,9,11.1
Jeremy Lamb,CHA,24,66,59,28.8%,59,147,40.1,49.3,12.2%,32,62,51.6,16.7%,27,85,31.8
Jeremy Lin,CHA,27,78,73,32.7%,96,237,40.5,48.9,17.0%,56,123,45.5,15.7%,40,114,35.1
Jerian Grant,NYK,23,76,45,25.1%,36,98,36.7,39.8,15.3%,30,60,50,9.7%,6,38,15.8
Jerryd Bayless,MIL,27,52,50,37.4%,72,163,44.2,58.6,13.5%,25,59,42.4,23.9%,47,104,45.2
Jimmer Fredette,SAS,27,6,1,20.0%,0,1,0,0,20.0%,0,1,0,0.0%,0,0,-
Jimmy Butler,CHI,26,67,65,26.9%,114,278,41,46.4,17.0%,84,176,47.7,9.9%,30,102,29.4
Joakim Noah,CHI,31,29,7,5.3%,3,7,42.9,42.9,4.5%,3,6,50,0.8%,0,1,0
Jodie Meeks,DET,28,3,3,45.0%,4,9,44.4,55.6,20.0%,2,4,50,25.0%,2,5,40
Joe Harris,CLE,24,5,1,25.0%,0,1,0,0,0.0%,0,0,-,25.0%,0,1,0
Joe Ingles,UTA,28,81,62,42.3%,48,123,39,53.3,8.6%,13,25,52,33.7%,35,98,35.7
Joe Johnson,MIA,35,81,76,31.1%,114,267,42.7,52.8,14.8%,60,127,47.2,16.3%,54,140,38.6
Joe Young,IND,24,41,28,39.6%,24,67,35.8,41.8,23.7%,16,40,40,16.0%,8,27,29.6
Joel Anthony,DET,33,19,2,20.0%,2,2,100,100,20.0%,2,2,100,0.0%,0,0,-
Joffrey Lauvergne,DEN,24,59,43,22.4%,47,85,55.3,55.9,19.3%,46,73,63,3.2%,1,12,8.3
John Henson,MIL,25,57,23,9.6%,17,28,60.7,60.7,9.3%,17,27,63,0.3%,0,1,0
John Jenkins,PHX,25,43,27,35.0%,23,56,41.1,50,20.0%,13,32,40.6,15.0%,10,24,41.7
John Wall,WAS,25,77,77,36.2%,191,488,39.1,44.7,24.3%,137,328,41.8,11.9%,54,160,33.8
Johnny O'Bryant III,MIL,23,66,35,30.1%,27,63,42.9,42.9,30.1%,27,63,42.9,0.0%,0,0,-
Jon Leuer,PHX,27,67,51,22.6%,50,105,47.6,53.3,15.3%,38,71,53.5,7.3%,12,34,35.3
Jonas Jerebko,BOS,29,77,31,16.3%,17,46,37,44.6,8.2%,10,23,43.5,8.2%,7,23,30.4
Jonas Valanciunas,TOR,24,59,42,12.4%,39,65,60,60,12.4%,39,65,60,0.0%,0,0,-
Jonathon Simmons,SAS,26,55,26,17.8%,20,43,46.5,52.3,10.8%,15,26,57.7,7.1%,5,17,29.4
Jordan Adams,MEM,21,2,1,16.7%,1,1,100,100,16.7%,1,1,100,0.0%,0,0,-
Jordan Clarkson,LAL,24,79,79,29.5%,135,324,41.7,48.9,15.4%,88,169,52.1,14.1%,47,155,30.3
Jordan Farmar,MEM,29,12,12,38.0%,13,38,34.2,44.7,14.0%,5,14,35.7,24.0%,8,24,33.3
Jordan Hamilton,NOP,25,11,11,37.9%,20,44,45.5,55.7,16.4%,11,19,57.9,21.6%,9,25,36
Jordan Hill,IND,28,73,58,21.9%,56,120,46.7,46.7,21.9%,56,120,46.7,0.0%,0,0,-
Jordan McRae,CLE,25,22,12,28.2%,11,22,50,61.4,14.1%,6,11,54.5,14.1%,5,11,45.5
Jordan Mickey,BOS,21,16,5,22.7%,1,5,20,20,22.7%,1,5,20,0.0%,0,0,-
Jorge Gutierrez,CHA,27,12,2,18.2%,1,2,50,50,18.2%,1,2,50,0.0%,0,0,-
Jose Calderon,NYK,34,72,68,42.5%,94,192,49,61.5,19.0%,46,86,53.5,23.5%,48,106,45.3
Josh Huestis,OKC,24,5,2,25.0%,2,3,66.7,100,8.3%,0,1,0,16.7%,2,2,100
Josh McRoberts,MIA,29,42,24,27.7%,12,41,29.3,32.9,18.9%,9,28,32.1,8.8%,3,13,23.1
Josh Richardson,MIA,22,52,38,32.0%,40,87,46,62.1,11.0%,12,30,40,21.0%,28,57,49.1
Josh Smith,HOU,30,55,37,21.2%,25,74,33.8,41.2,9.5%,14,33,42.4,11.7%,11,41,26.8
Jrue Holiday,NOP,26,65,65,29.0%,110,271,40.6,48.5,15.1%,67,141,47.5,13.9%,43,130,33.1
Julius Randle,LAL,21,81,68,15.1%,47,126,37.3,38.5,13.7%,44,114,38.6,1.4%,3,12,25
Justin Anderson,DAL,22,55,36,35.1%,25,61,41,50.8,12.6%,13,22,59.1,22.4%,12,39,30.8
Justin Harper,BKN,26,5,4,40.0%,2,4,50,75,0.0%,0,0,-,40.0%,2,4,50
Justin Holiday,CHI,27,53,33,34.4%,33,78,42.3,51.9,12.3%,18,28,64.3,22.0%,15,50,30
Justise Winslow,MIA,20,78,49,20.3%,43,94,45.7,49.5,14.0%,36,65,55.4,6.3%,7,29,24.1
Jusuf Nurkic,DEN,21,32,13,10.4%,12,25,48,48,10.0%,12,24,50,0.4%,0,1,0
KJ McDaniels,HOU,23,37,9,16.7%,6,12,50,50,9.7%,6,7,85.7,6.9%,0,5,0
Karl-Anthony Towns,MIN,20,82,81,25.8%,153,297,51.5,52.5,23.7%,147,273,53.8,2.1%,6,24,25
Kawhi Leonard,SAS,25,72,72,35.0%,189,381,49.6,58,21.1%,125,230,54.3,13.9%,64,151,42.4
Keith Appling,ORL,24,5,3,37.5%,0,3,0,0,25.0%,0,2,0,12.5%,0,1,0
Kelly Olynyk,BOS,25,68,56,24.1%,59,131,45,53.8,13.2%,36,72,50,10.8%,23,59,39
Kelly Oubre Jr.,WAS,20,63,30,23.2%,15,49,30.6,35.7,6.2%,10,13,76.9,17.1%,5,36,13.9
Kemba Walker,CHA,26,81,81,33.4%,187,444,42.1,52.1,15.8%,98,210,46.7,17.6%,89,234,38
Kendall Marshall,PHI,24,30,21,32.5%,13,38,34.2,43.4,17.1%,6,20,30,15.4%,7,18,38.9
Kendrick Perkins,NOP,31,37,13,18.7%,6,14,42.9,42.9,18.7%,6,14,42.9,0.0%,0,0,-
Kenneth Faried,DEN,26,67,52,16.8%,71,105,67.6,68.1,16.6%,70,104,67.3,0.2%,1,1,100
Kent Bazemore,ATL,26,75,67,20.0%,63,144,43.8,56.3,8.9%,27,64,42.2,11.1%,36,80,45
Kentavious Caldwell-Pope,DET,23,76,76,30.1%,118,288,41,50.5,13.6%,63,130,48.5,16.5%,55,158,34.8
Kevin Durant,OKC,27,72,69,26.9%,187,371,50.4,61.9,12.8%,102,177,57.6,14.1%,85,194,43.8
Kevin Garnett,MIN,40,38,16,15.7%,7,18,38.9,38.9,14.8%,7,17,41.2,0.9%,0,1,0
Kevin Love,CLE,27,77,74,29.6%,113,289,39.1,46.4,14.5%,71,141,50.4,15.2%,42,148,28.4
Kevin Martin,SAS,33,55,45,27.2%,45,114,39.5,49.1,13.8%,23,58,39.7,13.4%,22,56,39.3
Kevin Seraphin,NYK,26,48,30,23.0%,22,47,46.8,46.8,22.5%,22,46,47.8,0.5%,0,1,0
Kevon Looney,GSW,20,5,1,14.3%,0,1,0,0,14.3%,0,1,0,0.0%,0,0,-
Khris Middleton,MIL,24,79,78,26.8%,141,305,46.2,56.6,14.0%,78,160,48.8,12.7%,63,145,43.4
Kirk Hinrich,ATL,35,46,29,34.1%,17,44,38.6,51.1,11.6%,6,15,40,22.5%,11,29,37.9
Klay Thompson,GSW,26,80,79,35.1%,235,486,48.4,61.2,13.9%,110,192,57.3,21.3%,125,294,42.5
Kobe Bryant,LAL,37,66,65,26.8%,108,297,36.4,45.1,10.2%,56,113,49.6,16.6%,52,184,28.3
Kosta Koufos,SAC,27,77,39,16.3%,44,71,62,62,16.3%,44,71,62,0.0%,0,0,-
Kostas Papanikolaou,DEN,25,26,14,34.8%,8,23,34.8,45.7,12.1%,3,8,37.5,22.7%,5,15,33.3
Kris Humphries,ATL,31,53,40,24.1%,30,71,42.3,47.9,15.6%,22,46,47.8,8.5%,8,25,32
Kristaps Porzingis,NYK,20,72,69,28.1%,108,248,43.5,49.6,17.2%,78,152,51.3,10.9%,30,96,31.3
Kyle Anderson,SAS,22,78,40,24.8%,40,73,54.8,56.8,22.8%,37,67,55.2,2.0%,3,6,50
Kyle Korver,ATL,35,80,73,36.6%,106,225,47.1,63.1,10.3%,34,63,54,26.4%,72,162,44.4
Kyle Lowry,TOR,30,76,74,29.0%,141,341,41.3,54.5,9.2%,51,108,47.2,19.8%,90,233,38.6
Kyle O'Quinn,NYK,26,65,46,36.9%,51,100,51,51,34.7%,51,94,54.3,2.2%,0,6,0
Kyle Singler,OKC,28,68,46,33.9%,28,75,37.3,48,12.7%,12,28,42.9,21.3%,16,47,34
Kyrie Irving,CLE,24,53,53,26.3%,108,231,46.8,52.8,16.2%,80,142,56.3,10.1%,28,89,31.5
LaMarcus Aldridge,SAS,30,74,70,21.2%,114,221,51.6,51.6,21.0%,114,219,52.1,0.2%,0,2,0
Lamar Patterson,ATL,24,35,11,21.5%,5,17,29.4,38.2,6.3%,2,5,40,15.2%,3,12,25
Lance Stephenson,MEM,25,69,55,31.0%,64,147,43.5,46.3,27.0%,56,128,43.8,4.0%,8,19,42.1
Lance Thomas,NYK,28,59,45,24.9%,50,95,52.6,63.2,14.1%,30,54,55.6,10.7%,20,41,48.8
Langston Galloway,NYK,24,82,73,33.8%,69,199,34.7,42.7,16.5%,37,97,38.1,17.3%,32,102,31.4
Larry Nance Jr.,LAL,23,63,43,22.7%,35,68,51.5,51.5,21.0%,35,63,55.6,1.7%,0,5,0
Lavoy Allen,IND,27,79,51,19.7%,34,73,46.6,46.6,19.7%,34,73,46.6,0.0%,0,0,-
LeBron James,CLE,31,76,75,29.2%,183,412,44.4,49.5,19.0%,141,269,52.4,10.1%,42,143,29.4
Leandro Barbosa,GSW,33,68,47,27.0%,46,100,46,53,15.1%,32,56,57.1,11.9%,14,44,31.8
Lorenzo Brown,DET,25,8,4,36.0%,0,9,0,0,16.0%,0,4,0,20.0%,0,5,0
Lou Amundson,NYK,33,29,6,13.5%,1,7,14.3,14.3,13.5%,1,7,14.3,0.0%,0,0,-
Lou Williams,LAL,29,67,65,33.0%,84,229,36.7,46.3,13.3%,40,92,43.5,19.8%,44,137,32.1
Luc Mbah a Moute,LAC,29,75,23,14.5%,15,30,50,53.3,11.1%,13,23,56.5,3.4%,2,7,28.6
Lucas Nogueira,TOR,23,29,7,18.2%,5,8,62.5,68.8,13.6%,4,6,66.7,4.5%,1,2,50
Luis Montero,POR,23,12,4,42.1%,2,8,25,31.3,15.8%,1,3,33.3,26.3%,1,5,20
Luis Scola,TOR,36,75,58,26.1%,63,154,40.9,46.4,16.9%,46,100,46,9.2%,17,54,31.5
Luke Babbitt,NOP,27,47,31,20.4%,25,59,42.4,55.1,7.3%,10,21,47.6,13.1%,15,38,39.5
Luol Deng,MIA,31,74,73,29.9%,90,223,40.4,48.4,15.6%,54,116,46.6,14.4%,36,107,33.6
Manu Ginobili,SAS,38,58,52,32.3%,63,140,45,56.1,12.4%,32,54,59.3,19.8%,31,86,36
Marc Gasol,MEM,31,52,50,27.6%,83,195,42.6,42.6,27.4%,83,194,42.8,0.1%,0,1,0
Marcelo Huertas,LAL,33,53,37,27.4%,31,63,49.2,54.8,17.8%,24,41,58.5,9.6%,7,22,31.8
Marcin Gortat,WAS,32,75,67,21.7%,96,166,57.8,57.8,21.7%,96,166,57.8,0.0%,0,0,-
Marco Belinelli,SAC,30,67,67,38.3%,89,240,37.1,44.8,17.9%,52,112,46.4,20.4%,37,128,28.9
Marcus Morris,DET,26,80,79,32.4%,131,306,42.8,51.5,17.7%,78,167,46.7,14.7%,53,139,38.1
Marcus Smart,BOS,22,61,55,30.8%,59,163,36.2,46.3,7.9%,26,42,61.9,22.9%,33,121,27.3
Marcus Thornton,WAS,29,61,48,31.5%,71,171,41.5,54.7,8.5%,26,46,56.5,23.1%,45,125,36
Mario Chalmers,MIA,30,61,48,25.7%,44,114,38.6,46.9,12.2%,25,54,46.3,13.5%,19,60,31.7
Mario Hezonja,ORL,21,78,63,37.9%,69,157,43.9,56.4,15.2%,30,63,47.6,22.7%,39,94,41.5
Markel Brown,BKN,24,62,48,32.8%,38,105,36.2,44.3,13.8%,21,44,47.7,19.1%,17,61,27.9
Markieff Morris,WAS,26,64,60,28.7%,79,206,38.3,41.3,20.9%,67,150,44.7,7.8%,12,56,21.4
Marreese Speights,GSW,28,72,55,24.8%,56,113,49.6,51.3,22.2%,52,101,51.5,2.6%,4,12,33.3
Marvin Williams,CHA,30,81,80,32.1%,93,239,38.9,52.1,9.1%,30,68,44.1,23.0%,63,171,36.8
Mason Plumlee,POR,26,82,48,14.4%,43,74,58.1,58.1,14.2%,43,73,58.9,0.2%,0,1,0
Matt Barnes,MEM,36,76,69,36.7%,93,254,36.6,49.8,8.8%,26,61,42.6,27.9%,67,193,34.7
Matt Bonner,SAS,36,30,8,21.1%,6,12,50,66.7,3.5%,2,2,100,17.5%,4,10,40
Matthew Dellavedova,CLE,25,76,69,30.3%,64,155,41.3,53.2,12.3%,27,63,42.9,18.0%,37,92,40.2
Maurice Harkless,POR,23,78,50,19.6%,39,80,48.8,56.9,9.0%,26,37,70.3,10.5%,13,43,30.2
Metta World Peace,LAL,36,35,29,29.9%,17,53,32.1,40.6,12.4%,8,22,36.4,17.5%,9,31,29
Meyers Leonard,POR,24,61,56,33.8%,60,147,40.8,48.6,16.3%,37,71,52.1,17.5%,23,76,30.3
Michael Beasley,HOU,27,20,20,27.8%,29,57,50.9,53.5,25.9%,26,53,49.1,2.0%,3,4,75
Michael Carter-Williams,MIL,24,54,46,19.1%,48,106,45.3,46.7,17.1%,45,95,47.4,2.0%,3,11,27.3
Michael Kidd-Gilchrist,CHA,22,7,5,13.1%,3,8,37.5,37.5,11.5%,3,7,42.9,1.6%,0,1,0
Mike Conley,MEM,28,56,56,33.2%,94,231,40.7,49.6,18.0%,53,125,42.4,15.2%,41,106,38.7
Mike Dunleavy,CHI,35,31,27,31.0%,19,58,32.8,44,9.1%,6,17,35.3,21.9%,13,41,31.7
Mike Miller,DEN,36,47,21,46.8%,11,29,37.9,55.2,9.7%,1,6,16.7,37.1%,10,23,43.5
Mike Muscala,ATL,24,60,25,23.8%,20,36,55.6,59.7,19.2%,17,29,58.6,4.6%,3,7,42.9
Mike Scott,ATL,27,75,51,24.0%,40,90,44.4,52.2,13.3%,26,50,52,10.7%,14,40,35
Miles Plumlee,MIL,27,61,27,16.3%,27,38,71.1,71.1,16.3%,27,38,71.1,0.0%,0,0,-
Mirza Teletovic,PHX,30,79,74,40.1%,132,311,42.4,57.9,8.5%,36,66,54.5,31.6%,96,245,39.2
Mitch McGary,OKC,24,20,5,30.4%,3,7,42.9,42.9,21.7%,3,5,60,8.7%,0,2,0
Mo Williams,CLE,33,41,35,35.1%,48,106,45.3,50.9,21.2%,36,64,56.3,13.9%,12,42,28.6
Monta Ellis,IND,30,81,80,31.3%,120,319,37.6,41.8,20.1%,93,205,45.4,11.2%,27,114,23.7
Montrezl Harrell,HOU,22,39,10,14.9%,11,13,84.6,84.6,14.9%,11,13,84.6,0.0%,0,0,-
Myles Turner,IND,20,60,54,24.7%,60,131,45.8,46.2,24.5%,59,130,45.4,0.2%,1,1,100
Nazr Mohammed,OKC,38,5,1,20.0%,1,1,100,100,20.0%,1,1,100,0.0%,0,0,-
Nemanja Bjelica,MIN,28,60,39,30.2%,23,71,32.4,41.5,8.1%,10,19,52.6,22.1%,13,52,25
Nene,WAS,33,57,43,21.6%,37,83,44.6,44.6,21.4%,37,82,45.1,0.3%,0,1,0
Nerlens Noel,PHI,22,67,47,17.3%,63,101,62.4,62.4,17.3%,63,101,62.4,0.0%,0,0,-
Nick Collison,OKC,35,59,13,12.8%,6,14,42.9,42.9,12.8%,6,14,42.9,0.0%,0,0,-
Nick Young,LAL,31,54,49,34.7%,40,129,31,41.9,11.0%,12,41,29.3,23.7%,28,88,31.8
Nicolas Batum,CHA,27,70,68,31.9%,125,278,45,55,15.3%,69,133,51.9,16.6%,56,145,38.6
Nik Stauskas,PHI,22,73,60,29.4%,55,160,34.4,47.5,5.5%,13,30,43.3,23.9%,42,130,32.3
Nikola Jokic,DEN,21,80,51,20.0%,64,120,53.3,57.1,16.0%,55,96,57.3,4.0%,9,24,37.5
Nikola Mirotic,CHI,25,66,63,39.6%,92,241,38.2,51.7,12.0%,27,73,37,27.6%,65,168,38.7
Nikola Pekovic,MIN,30,12,5,14.0%,5,7,71.4,71.4,14.0%,5,7,71.4,0.0%,0,0,-
Nikola Vucevic,ORL,25,64,63,23.1%,124,236,52.5,53,22.8%,122,233,52.4,0.3%,2,3,66.7
Noah Vonleh,POR,20,78,30,15.5%,19,43,44.2,48.8,12.2%,15,34,44.1,3.2%,4,9,44.4
Norman Powell,TOR,23,48,32,33.6%,31,77,40.3,47.4,17.0%,20,39,51.3,16.6%,11,38,28.9
Norris Cole,NOP,27,45,45,36.0%,69,174,39.7,42.5,28.1%,59,136,43.4,7.9%,10,38,26.3
O.J. Mayo,MIL,28,41,35,41.4%,55,133,41.4,54.1,12.8%,21,41,51.2,28.7%,34,92,37
Omer Asik,NOP,29,68,11,6.2%,9,12,75,75,6.2%,9,12,75,0.0%,0,0,-
Omri Casspi,SAC,28,69,60,24.0%,80,149,53.7,65.4,9.8%,45,61,73.8,14.1%,35,88,39.8
Orlando Johnson,NOP,27,7,5,32.4%,3,11,27.3,31.8,17.6%,2,6,33.3,14.7%,1,5,20
Otto Porter,WAS,23,75,73,37.0%,126,265,47.5,54.7,21.6%,88,155,56.8,15.3%,38,110,34.5
PJ Hairston,MEM,23,66,58,33.4%,46,136,33.8,45.6,7.4%,14,30,46.7,26.0%,32,106,30.2
PJ Tucker,PHX,31,82,57,19.8%,44,115,38.3,47.4,8.4%,23,49,46.9,11.3%,21,66,31.8
Pablo Prigioni,LAC,39,59,31,33.3%,15,49,30.6,39.8,7.5%,6,11,54.5,25.9%,9,38,23.7
Pat Connaughton,POR,23,34,8,20.4%,2,10,20,25,10.2%,1,5,20,10.2%,1,5,20
Patrick Beverley,HOU,27,71,69,37.2%,88,221,39.8,52.5,12.6%,32,75,42.7,24.6%,56,146,38.4
Patrick Patterson,TOR,27,78,63,27.8%,45,135,33.3,44.1,8.2%,16,40,40,19.6%,29,95,30.5
Patty Mills,SAS,27,81,74,38.1%,84,233,36.1,45.1,15.8%,42,97,43.3,22.2%,42,136,30.9
Pau Gasol,CHI,35,72,71,26.7%,120,265,45.3,47,23.9%,111,237,46.8,2.8%,9,28,32.1
Paul George,IND,26,81,81,32.7%,207,472,43.9,54.7,15.6%,105,225,46.7,17.1%,102,247,41.3
Paul Millsap,ATL,31,81,78,24.7%,128,263,48.7,54,17.1%,100,182,54.9,7.6%,28,81,34.6
Paul Pierce,LAC,38,68,59,37.0%,51,147,34.7,45.2,10.1%,20,40,50,27.0%,31,107,29
Phil Pressey,POR,25,23,8,23.4%,9,18,50,55.6,15.6%,7,12,58.3,7.8%,2,6,33.3
Quincy Acy,SAC,25,58,22,19.0%,21,40,52.5,55,14.8%,19,31,61.3,4.3%,2,9,22.2
RJ Hunter,BOS,22,35,23,40.9%,11,38,28.9,35.5,10.8%,6,10,60,30.1%,5,28,17.9
Rajon Rondo,SAC,30,71,67,30.8%,104,239,43.5,48.5,22.2%,80,172,46.5,8.6%,24,67,35.8
Ramon Sessions,WAS,30,82,62,20.1%,58,119,48.7,54.2,13.5%,45,80,56.3,6.6%,13,39,33.3
Randy Foye,OKC,32,81,73,33.7%,45,162,27.8,38,7.9%,12,38,31.6,25.8%,33,124,26.6
Rashad Vaughn,MIL,19,70,42,29.2%,25,77,32.5,44.2,7.2%,7,19,36.8,22.0%,18,58,31
Rasual Butler,SAS,37,46,16,26.0%,12,27,44.4,53.7,9.6%,7,10,70,16.3%,5,17,29.4
Raul Neto,UTA,24,81,75,39.3%,68,164,41.5,52.7,19.2%,31,80,38.8,20.1%,37,84,44
Ray McCallum,SAS,25,41,22,37.2%,18,54,33.3,39.8,23.4%,11,34,32.4,13.8%,7,20,35
Raymond Felton,DAL,32,80,77,34.9%,89,238,37.4,43.7,19.4%,59,132,44.7,15.5%,30,106,28.3
Reggie Bullock,DET,25,37,21,40.8%,18,40,45,55,16.3%,10,16,62.5,24.5%,8,24,33.3
Reggie Jackson,DET,26,79,78,28.3%,144,351,41,50.3,13.0%,79,161,49.1,15.3%,65,190,34.2
Richard Jefferson,CLE,36,74,48,33.5%,55,104,52.9,68.8,10.0%,22,31,71,23.5%,33,73,45.2
Richaun Holmes,PHI,22,51,18,9.0%,9,20,45,47.5,6.8%,8,15,53.3,2.3%,1,5,20
Ricky Rubio,MIN,25,76,70,33.8%,63,198,31.8,37.9,20.0%,39,117,33.3,13.8%,24,81,29.6
Robert Covington,PHI,25,67,65,37.1%,94,264,35.6,50,4.4%,18,31,58.1,32.7%,76,233,32.6
Robert Sacre,LAL,27,25,8,16.0%,7,12,58.3,58.3,16.0%,7,12,58.3,0.0%,0,0,-
Robin Lopez,NYK,28,82,51,10.7%,43,71,60.6,60.6,10.7%,43,71,60.6,0.0%,0,0,-
Rodney Hood,UTA,23,79,78,31.6%,130,307,42.3,55.2,9.9%,51,96,53.1,21.7%,79,211,37.4
Rodney Stuckey,IND,30,58,48,24.7%,43,109,39.4,41.7,17.4%,38,77,49.4,7.2%,5,32,15.6
Rondae Hollis-Jefferson,BKN,21,29,19,29.7%,22,41,53.7,57.3,25.4%,19,35,54.3,4.3%,3,6,50
Ronnie Price,PHX,33,62,49,36.2%,43,109,39.4,52.8,8.6%,14,26,53.8,27.6%,29,83,34.9
Roy Hibbert,LAL,29,81,37,14.5%,24,59,40.7,40.7,14.5%,24,59,40.7,0.0%,0,0,-
Rudy Gay,SAC,29,69,66,23.8%,109,236,46.2,52.3,15.0%,80,149,53.7,8.8%,29,87,33.3
Rudy Gobert,UTA,24,61,29,11.3%,27,40,67.5,67.5,11.3%,27,40,67.5,0.0%,0,0,-
Russ Smith,MEM,25,15,4,18.2%,2,4,50,50,13.6%,2,3,66.7,4.5%,0,1,0
Russell Westbrook,OKC,27,80,79,27.7%,181,399,45.4,51.4,17.8%,133,257,51.8,9.8%,48,142,33.8
Ryan Anderson,NOP,28,66,64,32.6%,124,302,41.1,48.8,15.9%,77,147,52.4,16.8%,47,155,30.3
Ryan Hollins,MEM,31,37,9,13.9%,9,11,81.8,81.8,13.9%,9,11,81.8,0.0%,0,0,-
Ryan Kelly,LAL,25,36,19,20.8%,11,31,35.5,35.5,14.1%,11,21,52.4,6.7%,0,10,0
Salah Mejri,DAL,30,34,8,14.1%,6,11,54.5,54.5,12.8%,6,10,60,1.3%,0,1,0
Sasha Kaun,CLE,31,25,2,11.8%,2,2,100,100,11.8%,2,2,100,0.0%,0,0,-
Sasha Vujacic,NYK,32,61,43,36.6%,40,101,39.6,50,13.0%,19,36,52.8,23.6%,21,65,32.3
Sean Kilpatrick,BKN,26,31,28,36.7%,46,99,46.5,57.1,15.6%,25,42,59.5,21.1%,21,57,36.8
Serge Ibaka,OKC,26,78,75,28.8%,127,250,50.8,53.8,23.2%,112,201,55.7,5.7%,15,49,30.6
Sergey Karasev,BKN,22,40,15,34.2%,9,25,36,46,12.3%,4,9,44.4,21.9%,5,16,31.3
Seth Curry,SAC,25,43,26,31.8%,27,70,38.6,47.9,14.1%,14,31,45.2,17.7%,13,39,33.3
Shabazz Muhammad,MIN,23,82,68,20.0%,56,136,41.2,49.6,9.4%,33,64,51.6,10.6%,23,72,31.9
Shabazz Napier,ORL,24,55,39,44.3%,30,89,33.7,43.8,14.9%,12,30,40,29.4%,18,59,30.5
Shane Larkin,BKN,23,78,66,28.9%,63,145,43.4,48.6,21.4%,48,107,44.9,7.6%,15,38,39.5
Shaun Livingston,GSW,30,78,46,17.9%,38,68,55.9,55.9,17.2%,38,65,58.5,0.8%,0,3,0
Shayne Whittington,IND,25,7,1,27.3%,0,3,0,0,18.2%,0,2,0,9.1%,0,1,0
Shelvin Mack,UTA,26,52,40,27.4%,46,113,40.7,47.3,17.0%,31,70,44.3,10.4%,15,43,34.9
Solomon Hill,IND,25,59,29,27.1%,28,56,50,58,13.0%,19,27,70.4,14.0%,9,29,31
Sonny Weems,PHX,29,43,24,36.7%,18,40,45,52.5,18.3%,12,20,60,18.3%,6,20,30
Spencer Dinwiddie,CHI,23,12,6,24.5%,3,13,23.1,23.1,13.2%,3,7,42.9,11.3%,0,6,0
Spencer Hawes,CHA,28,57,38,22.3%,31,68,45.6,52.2,14.1%,22,43,51.2,8.2%,9,25,36
Stanley Johnson,DET,20,73,64,31.1%,63,186,33.9,40.3,16.5%,39,99,39.4,14.5%,24,87,27.6
Stephen Curry,GSW,28,79,79,36.8%,311,586,53.1,70.3,11.1%,109,177,61.6,25.7%,202,409,49.4
Steve Blake,DET,36,58,45,33.8%,30,81,37,49.4,8.3%,10,20,50,25.4%,20,61,32.8
Steve Novak,MIL,33,10,6,44.4%,3,8,37.5,56.3,5.6%,0,1,0,38.9%,3,7,42.9
Steven Adams,OKC,22,80,44,14.7%,48,62,77.4,77.4,14.7%,48,62,77.4,0.0%,0,0,-
TJ McConnell,PHI,24,81,61,27.6%,70,128,54.7,58.2,23.5%,61,109,56,4.1%,9,19,47.4
TJ Warren,PHX,22,47,42,33.6%,71,148,48,53,26.1%,56,115,48.7,7.5%,15,33,45.5
Taj Gibson,CHI,31,73,53,21.6%,57,108,52.8,52.8,21.2%,57,106,53.8,0.4%,0,2,0
Tarik Black,LAL,24,39,11,14.4%,9,15,60,60,14.4%,9,15,60,0.0%,0,0,-
Tayshaun Prince,MIN,36,77,53,32.6%,34,74,45.9,46.6,30.4%,33,69,47.8,2.2%,1,5,20
Terrence Jones,HOU,24,50,33,16.8%,27,61,44.3,51.6,8.8%,18,32,56.3,8.0%,9,29,31
Terrence Ross,TOR,25,72,68,39.5%,108,244,44.3,56.4,15.6%,49,96,51,24.0%,59,148,39.9
Terry Rozier,BOS,22,38,22,29.1%,12,30,40,48.3,14.6%,7,15,46.7,14.6%,5,15,33.3
Thabo Sefolosha,ATL,32,75,53,28.5%,56,105,53.3,61.4,17.3%,39,64,60.9,11.1%,17,41,41.5
Thaddeus Young,BKN,28,73,67,19.1%,101,183,55.2,55.7,18.1%,99,174,56.9,0.9%,2,9,22.2
Thanasis Antetokounmpo,NYK,23,2,1,50.0%,1,2,50,50,25.0%,1,1,100,25.0%,0,1,0
Thomas Robinson,BKN,25,71,38,18.9%,20,55,36.4,36.4,18.9%,20,55,36.4,0.0%,0,0,-
Tiago Splitter,ATL,31,36,16,12.3%,13,19,68.4,68.4,11.6%,13,18,72.2,0.6%,0,1,0
Tibor Pleiss,UTA,26,12,4,24.0%,3,6,50,50,20.0%,3,5,60,4.0%,0,1,0
Tim Duncan,SAS,40,61,40,16.1%,33,71,46.5,46.5,15.9%,33,70,47.1,0.2%,0,1,0
Tim Frazier,NOP,25,51,22,24.5%,21,56,37.5,42.9,15.3%,15,35,42.9,9.2%,6,21,28.6
Tim Hardaway Jr.,ATL,24,51,44,30.4%,31,80,38.8,49.4,9.5%,14,25,56,20.9%,17,55,30.9
Timofey Mozgov,CLE,29,76,43,17.3%,39,62,62.9,62.9,17.0%,39,61,63.9,0.3%,0,1,0
Tobias Harris,DET,23,75,74,22.7%,77,198,38.9,45.7,12.3%,50,107,46.7,10.4%,27,91,29.7
Toney Douglas,NOP,30,61,47,30.6%,49,136,36,47.1,13.0%,19,58,32.8,17.5%,30,78,38.5
Tony Allen,MEM,34,64,44,14.3%,29,67,43.3,44,13.0%,28,61,45.9,1.3%,1,6,16.7
Tony Parker,SAS,34,72,65,31.5%,106,223,47.5,50.9,26.7%,91,189,48.1,4.8%,15,34,44.1
Tony Snell,CHI,24,64,50,31.9%,38,108,35.2,46.3,11.2%,14,38,36.8,20.6%,24,70,34.3
Tony Wroten,NYK,23,8,6,13.8%,4,9,44.4,50,4.6%,3,3,100,9.2%,1,6,16.7
Trevor Ariza,HOU,31,81,77,31.5%,107,270,39.6,52.8,8.9%,36,76,47.4,22.7%,71,194,36.6
Trevor Booker,UTA,28,79,46,17.8%,30,69,43.5,44.2,15.2%,29,59,49.2,2.6%,1,10,10
Trey Burke,UTA,23,64,58,36.8%,83,233,35.6,44.4,15.1%,42,96,43.8,21.6%,41,137,29.9
Trey Lyles,UTA,20,80,50,20.7%,42,90,46.7,52.2,14.9%,32,65,49.2,5.7%,10,25,40
Tristan Thompson,CLE,25,82,43,12.9%,36,54,66.7,66.7,12.9%,36,54,66.7,0.0%,0,0,-
Troy Daniels,CHA,24,43,33,40.1%,34,75,45.3,60.7,11.8%,11,22,50,28.3%,23,53,43.4
Ty Lawson,IND,28,66,56,34.3%,48,121,39.7,45.5,22.7%,34,80,42.5,11.6%,14,41,34.1
Tyler Ennis,MIL,21,46,24,21.4%,18,40,45,53.8,11.8%,11,22,50,9.6%,7,18,38.9
Tyler Hansbrough,CHA,30,44,8,12.7%,5,9,55.6,55.6,12.7%,5,9,55.6,0.0%,0,0,-
Tyler Johnson,MIA,24,36,31,30.6%,38,74,51.4,61.5,16.9%,23,41,56.1,13.6%,15,33,45.5
Tyler Zeller,BOS,26,59,37,20.1%,28,58,48.3,48.3,20.1%,28,58,48.3,0.0%,0,0,-
Tyreke Evans,NOP,26,25,24,21.7%,33,68,48.5,59.6,11.2%,18,35,51.4,10.5%,15,33,45.5
Tyson Chandler,PHX,33,66,35,15.3%,31,48,64.6,64.6,15.3%,31,48,64.6,0.0%,0,0,-
Tyus Jones,MIN,20,37,23,24.4%,13,38,34.2,42.1,10.3%,7,16,43.8,14.1%,6,22,27.3
Udonis Haslem,MIA,36,37,18,44.3%,13,27,48.1,48.1,42.6%,13,26,50,1.6%,0,1,0
Victor Oladipo,ORL,24,71,70,32.2%,129,305,42.3,49.2,18.7%,87,177,49.2,13.5%,42,128,32.8
Vince Carter,MEM,39,60,52,39.4%,48,135,35.6,45.2,15.7%,22,54,40.7,23.6%,26,81,32.1
Wayne Ellington,BKN,28,76,70,40.1%,87,225,38.7,49.6,15.3%,38,86,44.2,24.8%,49,139,35.3
Wesley Johnson,LAC,28,80,71,39.2%,79,202,39.1,49.3,13.4%,38,69,55.1,25.8%,41,133,30.8
Wesley Matthews,DAL,29,78,78,35.6%,118,304,38.8,51,10.9%,44,93,47.3,24.7%,74,211,35.1
Will Barton,DEN,25,82,79,29.4%,120,289,41.5,52.2,12.2%,58,120,48.3,17.2%,62,169,36.7
Willie Cauley-Stein,SAC,22,65,36,23.7%,52,80,65,65,23.7%,52,80,65,0.0%,0,0,-
Willie Reed,BKN,26,39,12,12.8%,10,17,58.8,58.8,12.8%,10,17,58.8,0.0%,0,0,-
Xavier Munford,MEM,24,14,10,26.3%,7,20,35,45,10.5%,3,8,37.5,15.8%,4,12,33.3
Zach LaVine,MIN,21,82,79,31.1%,139,297,46.8,56.1,16.9%,84,161,52.2,14.2%,55,136,40.4
Zach Randolph,MEM,34,68,66,24.6%,98,223,43.9,44.4,23.8%,96,216,44.4,0.8%,2,7,28.6
