Rk,Player,Pos,Age,Tm,G,GS,MP,FG,FGA,FG%,3P,3PA,3P%,2P,2PA,2P%,eFG%,FT,FTA,FT%,ORB,DRB,TRB,AST,STL,BLK,TOV,PF,PTS
1,Alex Abrines\abrinal01,SG,23,OKC,14,0,197,23,63,.365,12,42,.286,11,21,.524,.460,10,11,.909,2,13,15,7,5,1,12,14,68
2,Quincy Acy\acyqu01,PF,26,DAL,6,0,48,5,17,.294,1,8,.125,4,9,.444,.324,2,3,.667,2,6,8,0,0,0,2,9,13
3,Steven Adams\adamsst01,C,23,OKC,15,15,480,62,117,.530,0,0,,62,117,.530,.530,34,38,.895,45,75,120,12,21,17,35,38,158
4,Arron Afflalo\afflaar01,SG,31,SAC,14,13,394,47,109,.431,12,33,.364,35,76,.461,.486,29,31,.935,4,33,37,11,4,1,4,28,135
5,Alexis Ajinca\ajincal01,C,28,NOP,7,0,94,12,27,.444,0,0,,12,27,.444,.444,3,4,.750,8,18,26,1,1,5,5,13,27
6,Cole Aldrich\aldrico01,C,28,MIN,13,0,161,15,28,.536,0,0,,15,28,.536,.536,3,7,.429,13,31,44,5,9,5,3,33,33
7,LaMarcus Aldridge\aldrila01,PF,31,SAS,12,12,390,83,174,.477,7,12,.583,76,162,.469,.497,46,52,.885,19,64,83,16,10,13,20,28,219
8,Lavoy Allen\allenla01,PF,27,IND,15,0,229,15,44,.341,0,1,.000,15,43,.349,.341,2,4,.500,20,24,44,17,4,5,7,22,32
9,Tony Allen\allento01,SG,35,MEM,7,5,157,20,50,.400,2,5,.400,18,45,.400,.420,8,12,.667,12,13,25,3,13,4,7,21,50
10,Al-Farouq Aminu\aminual01,SF,26,POR,8,8,209,17,61,.279,9,36,.250,8,25,.320,.352,8,15,.533,7,46,53,13,12,7,12,10,51
11,Chris Andersen\anderch01,C,38,CLE,4,0,30,3,9,.333,0,1,.000,3,8,.375,.333,4,6,.667,5,6,11,1,2,2,3,4,10
12,Alan Anderson\anderal01,SF,34,LAC,1,0,9,1,3,.333,1,2,.500,0,1,.000,.500,0,0,,1,0,1,1,0,0,1,1,3
13,Justin Anderson\anderju01,SF,23,DAL,13,2,281,34,101,.337,6,37,.162,28,64,.438,.366,16,23,.696,19,37,56,15,12,8,15,22,90
14,Kyle Anderson\anderky01,SG,23,SAS,13,7,222,12,33,.364,4,8,.500,8,25,.320,.424,3,4,.750,8,34,42,12,11,4,4,10,31
15,Ryan Anderson\anderry01,PF,28,HOU,14,14,448,61,159,.384,34,85,.400,27,74,.365,.491,15,18,.833,30,57,87,9,4,2,13,23,171
16,Giannis Antetokounmpo\antetgi01,SG,22,MIL,13,13,456,106,215,.493,5,30,.167,101,185,.546,.505,66,84,.786,23,87,110,75,26,28,42,48,283
17,Carmelo Anthony\anthoca01,SF,32,NYK,14,14,466,117,254,.461,28,82,.341,89,172,.517,.516,53,62,.855,13,66,79,36,13,4,28,45,315
18,Trevor Ariza\arizatr01,SF,31,HOU,14,14,473,59,141,.418,39,102,.382,20,39,.513,.557,13,16,.813,9,62,71,29,30,3,13,20,170
19,Darrell Arthur\arthuda01,PF,28,DEN,2,0,15,2,6,.333,1,2,.500,1,4,.250,.417,0,0,,0,4,4,1,0,0,0,2,5
20,Omer Asik\asikom01,C,30,NOP,15,11,270,17,37,.459,0,0,,17,37,.459,.459,12,21,.571,26,71,97,10,1,6,9,25,46
21,D.J. Augustin\augusdj01,PG,29,ORL,14,0,258,43,109,.394,18,55,.327,25,54,.463,.477,27,30,.900,1,11,12,37,4,0,18,14,131
22,Luke Babbitt\babbilu01,SF,27,MIA,13,8,194,18,54,.333,14,41,.341,4,13,.308,.463,3,3,1.000,4,22,26,7,4,0,6,11,53
23,Ron Baker\bakerro01,SG,23,NYK,4,0,34,4,13,.308,2,7,.286,2,6,.333,.385,1,2,.500,1,1,2,2,3,1,1,1,11
24,Wade Baldwin\baldwwa01,PG,20,MEM,9,1,143,11,38,.289,2,9,.222,9,29,.310,.316,4,4,1.000,4,12,16,22,9,3,14,11,28
25,Leandro Barbosa\barbole01,SG,34,PHO,14,0,177,34,67,.507,7,16,.438,27,51,.529,.560,5,6,.833,3,14,17,20,5,0,3,11,80
26,J.J. Barea\bareajo01,PG,32,DAL,9,5,298,51,123,.415,18,47,.383,33,76,.434,.488,27,28,.964,4,27,31,49,6,1,18,8,147
27,Harrison Barnes\barneha02,SF,24,DAL,13,13,495,107,231,.463,11,38,.289,96,193,.497,.487,50,58,.862,18,59,77,13,8,3,20,26,275
28,Matt Barnes\barnema02,SF,36,SAC,14,2,354,40,101,.396,21,60,.350,19,41,.463,.500,13,17,.765,14,53,67,32,10,6,28,38,114
29,Will Barton\bartowi01,SG,26,DEN,5,5,151,22,54,.407,7,14,.500,15,40,.375,.472,20,22,.909,6,15,21,11,0,2,5,7,71
30,Brandon Bass\bassbr01,PF,31,LAC,8,0,80,12,23,.522,1,1,1.000,11,22,.500,.543,6,6,1.000,5,9,14,3,1,2,2,6,31
31,Nicolas Batum\batumni01,SG,28,CHO,13,13,442,57,147,.388,26,77,.338,31,70,.443,.476,43,52,.827,11,74,85,65,17,7,28,25,183
32,Jerryd Bayless\bayleje01,PG,28,PHI,1,0,15,1,7,.143,0,2,.000,1,5,.200,.143,2,2,1.000,1,1,2,5,0,0,2,0,4
33,Aron Baynes\baynear01,C,30,DET,15,1,242,26,57,.456,0,0,,26,57,.456,.456,19,23,.826,14,46,60,5,6,6,12,26,71
34,Kent Bazemore\bazemke01,SF,27,ATL,14,14,389,57,143,.399,16,52,.308,41,91,.451,.455,28,34,.824,6,36,42,42,23,10,26,33,158
35,Bradley Beal\bealbr01,SG,23,WAS,10,10,329,68,160,.425,22,61,.361,46,99,.465,.494,44,51,.863,8,18,26,26,9,6,16,24,202
36,Malik Beasley\beaslma01,SG,20,DEN,6,0,31,5,16,.313,2,6,.333,3,10,.300,.375,1,2,.500,0,2,2,2,0,0,0,2,13
37,Michael Beasley\beaslmi01,SF,28,MIL,13,0,188,46,91,.505,4,10,.400,42,81,.519,.527,14,22,.636,10,27,37,8,6,2,11,19,110
38,Marco Belinelli\belinma01,SG,30,CHO,13,0,340,43,105,.410,24,50,.480,19,55,.345,.524,21,24,.875,1,37,38,27,13,3,12,18,131
39,DeAndre' Bembry\bembrde01,SF,22,ATL,5,0,25,3,10,.300,0,2,.000,3,8,.375,.300,0,0,,2,3,5,2,0,0,0,0,6
40,Dragan Bender\bendedr01,PF,19,PHO,10,0,96,13,31,.419,6,17,.353,7,14,.500,.516,0,1,.000,3,7,10,4,2,3,5,13,32
41,Anthony Bennett\bennean01,PF,23,BRK,8,0,91,14,38,.368,7,23,.304,7,15,.467,.461,10,15,.667,5,16,21,5,3,0,2,5,45
42,Davis Bertans\bertada01,PF,24,SAS,11,1,119,9,27,.333,8,22,.364,1,5,.200,.481,1,2,.500,5,11,16,4,0,6,3,12,27
43,Patrick Beverley\beverpa01,SG,28,HOU,3,3,75,11,21,.524,3,6,.500,8,15,.533,.595,0,0,,2,2,4,10,4,3,3,8,25
44,Bismack Biyombo\biyombi01,C,24,ORL,13,0,296,28,56,.500,0,0,,28,56,.500,.500,18,35,.514,38,71,109,11,2,21,19,35,74
45,Nemanja Bjelica\bjeline01,PF,28,MIN,13,1,217,30,73,.411,15,41,.366,15,32,.469,.514,11,15,.733,7,39,46,13,7,5,13,33,86
46,Tarik Black\blackta01,C,25,LAL,15,0,213,31,56,.554,0,0,,31,56,.554,.554,17,20,.850,31,48,79,9,3,9,11,36,79
47,Eric Bledsoe\bledser01,PG,27,PHO,15,15,481,95,211,.450,15,57,.263,80,154,.519,.486,67,85,.788,16,70,86,76,17,2,46,48,272
48,Bojan Bogdanovic\bogdabo02,SF,27,BRK,13,13,359,67,143,.469,21,63,.333,46,80,.575,.542,37,41,.902,9,34,43,15,8,1,19,22,192
49,Andrew Bogut\bogutan01,C,32,DAL,10,10,256,19,46,.413,0,1,.000,19,45,.422,.413,0,4,.000,23,76,99,18,4,11,19,33,38
50,Joel Bolomboy\bolomjo01,PF,23,UTA,5,0,11,1,1,1.000,0,0,,1,1,1.000,1.000,1,2,.500,0,5,5,1,1,2,1,1,3
51,Devin Booker\bookede01,SG,20,PHO,14,14,466,103,246,.419,23,70,.329,80,176,.455,.465,50,60,.833,7,31,38,35,11,4,35,39,279
52,Trevor Booker\booketr01,PF,29,BRK,13,13,340,52,98,.531,4,14,.286,48,84,.571,.551,19,23,.826,22,79,101,25,24,9,15,28,127
53,Avery Bradley\bradlav01,SG,26,BOS,14,14,500,99,213,.465,30,75,.400,69,138,.500,.535,18,24,.750,21,92,113,42,13,5,27,38,246
54,Corey Brewer\breweco01,SF,30,HOU,14,3,215,24,55,.436,4,23,.174,20,32,.625,.473,12,17,.706,9,21,30,14,6,2,9,25,64
55,Malcolm Brogdon\brogdma01,SG,24,MIL,13,0,264,32,88,.364,6,24,.250,26,64,.406,.398,18,20,.900,5,28,33,34,13,1,17,17,88
56,Aaron Brooks\brookaa01,PG,32,IND,12,0,191,31,74,.419,12,32,.375,19,42,.452,.500,8,10,.800,2,7,9,33,6,3,15,27,82
57,Anthony Brown\brownan02,SF,24,NOP,1,0,8,0,1,.000,0,1,.000,0,0,,.000,0,0,,1,0,1,0,1,1,2,1,0
58,Bobby Brown\brownbo02,PG,32,HOU,6,0,22,1,12,.083,0,4,.000,1,8,.125,.083,0,0,,0,2,2,0,0,0,1,2,2
59,Jaylen Brown\brownja02,SF,20,BOS,14,3,231,34,75,.453,8,24,.333,26,51,.510,.507,15,26,.577,12,20,32,11,10,6,11,25,91
60,Nicolas Brussino\brussni01,SF,23,DAL,11,0,73,6,14,.429,4,9,.444,2,5,.400,.571,5,6,.833,2,9,11,6,3,1,5,4,21
61,Reggie Bullock\bullore01,SF,25,DET,3,0,38,7,14,.500,2,6,.333,5,8,.625,.571,0,0,,3,2,5,1,1,2,1,0,16
62,Trey Burke\burketr01,PG,24,WAS,11,0,136,22,50,.440,3,6,.500,19,44,.432,.470,3,6,.500,2,6,8,13,2,1,7,7,50
63,Jimmy Butler\butleji01,SF,27,CHI,15,15,533,118,246,.480,22,52,.423,96,194,.495,.524,129,145,.890,28,72,100,62,24,2,31,26,387
64,Jose Calderon\caldejo01,PG,35,LAL,7,2,76,10,18,.556,7,12,.583,3,6,.500,.750,2,2,1.000,2,12,14,10,3,0,9,6,29
65,Kentavious Caldwell-Pope\caldwke01,SG,23,DET,15,15,500,73,184,.397,28,75,.373,45,109,.413,.473,32,41,.780,13,30,43,37,19,1,16,25,206
66,Isaiah Canaan\canaais01,SG,25,CHI,15,0,285,36,85,.424,16,51,.314,20,34,.588,.518,17,20,.850,1,21,22,18,11,1,8,20,105
67,Clint Capela\capelca01,C,22,HOU,14,14,353,74,121,.612,0,0,,74,121,.612,.612,13,32,.406,37,86,123,14,6,25,20,39,161
68,DeMarre Carroll\carrode01,SF,30,TOR,11,11,282,32,81,.395,15,46,.326,17,35,.486,.488,14,18,.778,6,37,43,7,9,4,3,22,93
69,Vince Carter\cartevi01,SG,40,MEM,14,0,386,49,114,.430,21,65,.323,28,49,.571,.522,20,26,.769,10,48,58,28,11,6,10,37,139
70,Michael Carter-Williams\cartemi01,PG,25,CHI,3,0,45,4,15,.267,1,2,.500,3,13,.231,.300,3,4,.750,3,6,9,8,2,2,6,6,12
71,Omri Casspi\casspom01,SF,28,SAC,6,1,92,12,29,.414,2,9,.222,10,20,.500,.448,0,0,,7,12,19,3,3,0,8,6,26
72,Willie Cauley-Stein\caulewi01,C,23,SAC,12,0,150,25,45,.556,0,0,,25,45,.556,.556,9,14,.643,9,13,22,4,5,6,10,31,59
73,Tyson Chandler\chandty01,C,34,PHO,8,8,222,23,33,.697,0,0,,23,33,.697,.697,11,17,.647,17,81,98,4,4,4,11,26,57
74,Wilson Chandler\chandwi01,SF,29,DEN,12,0,361,81,174,.466,14,45,.311,67,129,.519,.506,28,39,.718,19,69,88,20,7,3,19,26,204
75,Marquese Chriss\chrisma01,PF,19,PHO,15,8,225,35,83,.422,6,20,.300,29,63,.460,.458,10,20,.500,13,34,47,8,6,7,25,43,86
76,Rakeem Christmas\chrisra01,PF,25,IND,2,0,12,1,4,.250,0,0,,1,4,.250,.250,1,1,1.000,1,2,3,1,0,1,0,1,3
77,Semaj Christon\chrisse01,PG,24,OKC,14,0,212,20,64,.313,3,11,.273,17,53,.321,.336,4,7,.571,4,15,19,34,5,1,10,18,47
78,Ian Clark\clarkia01,SG,25,GSW,12,0,161,26,58,.448,9,27,.333,17,31,.548,.526,5,6,.833,2,17,19,10,6,2,6,12,66
79,Jordan Clarkson\clarkjo01,SG,24,LAL,15,0,399,87,186,.468,17,49,.347,70,137,.511,.513,30,36,.833,9,31,40,34,26,3,33,30,221
80,Darren Collison\collida01,PG,29,SAC,6,2,183,30,62,.484,3,12,.250,27,50,.540,.508,13,16,.813,3,11,14,34,8,0,13,11,76
81,Nick Collison\collini01,PF,36,OKC,5,0,22,0,2,.000,0,0,,0,2,.000,.000,0,0,,0,2,2,5,0,0,1,3,0
82,Mike Conley\conlemi01,PG,29,MEM,13,13,424,79,175,.451,34,69,.493,45,106,.425,.549,58,65,.892,5,40,45,73,19,9,31,23,250
83,Pat Connaughton\connapa01,SG,24,POR,6,0,35,2,4,.500,0,1,.000,2,3,.667,.500,2,3,.667,0,4,4,4,0,1,0,0,6
84,DeMarcus Cousins\couside01,C,26,SAC,14,14,472,122,267,.457,17,52,.327,105,215,.488,.489,115,149,.772,33,102,135,49,16,13,39,58,376
85,Robert Covington\covinro01,SF,26,PHI,14,14,381,32,122,.262,21,86,.244,11,36,.306,.348,18,24,.750,13,55,68,15,26,10,20,33,103
86,Allen Crabbe\crabbal01,SG,24,POR,16,1,463,53,121,.438,22,60,.367,31,61,.508,.529,22,27,.815,5,37,42,25,9,4,12,34,150
87,Jamal Crawford\crawfja01,SG,36,LAC,15,0,357,58,143,.406,18,57,.316,40,86,.465,.469,30,33,.909,2,20,22,31,13,1,18,17,164
88,Jae Crowder\crowdja01,SF,26,BOS,6,6,159,25,51,.490,10,26,.385,15,25,.600,.588,7,7,1.000,2,32,34,8,6,5,12,15,67
89,Dante Cunningham\cunnida01,SF,29,NOP,14,9,342,32,82,.390,16,39,.410,16,43,.372,.488,2,5,.400,13,44,57,8,9,9,9,25,82
90,Seth Curry\curryse01,PG,26,DAL,13,5,359,52,125,.416,21,60,.350,31,65,.477,.500,6,10,.600,6,25,31,38,16,3,18,25,131
91,Stephen Curry\curryst01,PG,28,GSW,14,14,464,120,249,.482,56,137,.409,64,112,.571,.594,69,75,.920,10,43,53,84,18,4,41,34,365
92,Troy Daniels\danietr01,SG,25,MEM,4,0,32,1,13,.077,0,10,.000,1,3,.333,.077,2,2,1.000,0,0,0,2,0,0,1,2,4
93,Anthony Davis\davisan02,PF,23,NOP,14,14,512,150,298,.503,7,30,.233,143,268,.534,.515,118,145,.814,23,128,151,28,26,42,34,29,425
94,Deyonta Davis\davisde01,C,20,MEM,10,0,68,9,16,.563,0,0,,9,16,.563,.563,4,8,.500,6,12,18,0,2,4,2,11,22
95,Ed Davis\davised01,PF,27,POR,16,3,259,21,45,.467,0,0,,21,45,.467,.467,12,22,.545,29,52,81,9,5,10,13,50,54
96,Dewayne Dedmon\dedmode01,C,27,SAS,11,0,144,16,36,.444,0,0,,16,36,.444,.444,10,14,.714,20,34,54,2,6,15,6,27,42
97,Sam Dekker\dekkesa01,SF,22,HOU,14,0,237,34,63,.540,12,26,.462,22,37,.595,.635,3,6,.500,11,37,48,13,6,3,7,19,83
98,Malcolm Delaney\delanma01,PG,27,ATL,14,0,241,31,83,.373,5,21,.238,26,62,.419,.404,16,17,.941,3,27,30,51,6,0,25,16,83
99,Matthew Dellavedova\dellama01,PG,26,MIL,13,13,376,39,96,.406,11,35,.314,28,61,.459,.464,10,12,.833,5,36,41,78,13,1,30,26,99
100,Luol Deng\denglu01,SF,31,LAL,15,15,364,36,107,.336,13,39,.333,23,68,.338,.397,16,21,.762,19,62,81,20,9,3,11,20,101
101,DeMar DeRozan\derozde01,SG,27,TOR,14,14,517,159,324,.491,6,26,.231,153,298,.513,.500,109,135,.807,15,58,73,52,20,0,38,31,433
102,Cheick Diallo\diallch01,PF,20,NOP,1,0,6,0,2,.000,0,0,,0,2,.000,.000,0,0,,1,0,1,0,0,1,0,0,0
103,Boris Diaw\diawbo01,PF,34,UTA,6,4,119,5,21,.238,1,8,.125,4,13,.308,.262,2,2,1.000,4,7,11,4,1,0,8,13,13
104,Gorgui Dieng\dienggo01,PF,27,MIN,13,13,411,56,105,.533,0,4,.000,56,101,.554,.533,19,27,.704,36,78,114,32,13,16,29,44,131
105,Goran Dragic\dragigo01,PG,30,MIA,10,10,327,58,134,.433,17,40,.425,41,94,.436,.496,29,37,.784,10,30,40,58,12,3,31,25,162
106,Andre Drummond\drumman01,C,23,DET,14,14,423,87,176,.494,1,1,1.000,86,175,.491,.497,30,63,.476,50,145,195,17,19,14,32,34,205
107,Jared Dudley\dudleja01,PF,31,PHO,15,7,378,47,96,.490,23,52,.442,24,44,.545,.609,15,26,.577,11,43,54,34,12,4,17,42,132
108,Mike Dunleavy\dunlemi02,SF,36,CLE,11,1,183,16,44,.364,9,30,.300,7,14,.500,.466,6,8,.750,1,22,23,10,4,2,6,16,47
109,Kris Dunn\dunnkr01,PG,22,MIN,13,5,252,16,51,.314,3,11,.273,13,40,.325,.343,13,23,.565,6,30,36,42,17,3,17,30,48
110,Kevin Durant\duranke01,SF,28,GSW,14,14,482,134,238,.563,29,69,.420,105,169,.621,.624,80,95,.842,9,106,115,63,25,18,31,29,377
111,Henry Ellenson\ellenhe01,PF,20,DET,5,0,14,1,3,.333,0,0,,1,3,.333,.333,0,0,,1,5,6,1,0,0,0,0,2
112,Monta Ellis\ellismo01,SG,31,IND,15,14,506,60,136,.441,9,33,.273,51,103,.495,.474,24,29,.828,3,52,55,67,21,11,44,38,153
113,Joel Embiid\embiijo01,C,22,PHI,10,10,222,60,122,.492,11,22,.500,49,100,.490,.537,53,68,.779,18,55,73,11,5,23,39,34,184
114,James Ennis\ennisja01,SF,26,MEM,14,13,409,42,95,.442,14,41,.341,28,54,.519,.516,29,36,.806,23,51,74,19,13,2,15,44,127
115,Tyler Ennis\ennisty01,PG,22,HOU,12,0,113,17,40,.425,4,11,.364,13,29,.448,.475,1,2,.500,4,7,11,19,5,0,13,19,39
116,Dante Exum\exumda01,PG,21,UTA,15,6,351,43,102,.422,12,41,.293,31,61,.508,.480,16,20,.800,12,28,40,25,3,5,14,35,114
117,Kenneth Faried\farieke01,PF,27,DEN,14,6,329,43,90,.478,0,3,.000,43,87,.494,.478,36,52,.692,52,78,130,13,18,16,18,28,122
118,Jordan Farmar\farmajo01,PG,30,SAC,2,0,35,4,12,.333,4,9,.444,0,3,.000,.500,0,0,,1,2,3,9,2,0,3,1,12
119,Derrick Favors\favorde01,PF,25,UTA,11,9,264,46,98,.469,1,2,.500,45,96,.469,.474,22,36,.611,16,57,73,6,11,11,14,25,115
120,Kay Felder\feldeka01,PG,21,CLE,4,0,32,4,12,.333,0,1,.000,4,11,.364,.333,5,6,.833,1,5,6,5,0,0,2,2,13
121,Cristiano Felicio\feliccr01,C,24,CHI,10,0,97,10,22,.455,0,0,,10,22,.455,.455,3,4,.750,13,17,30,5,2,0,4,13,23
122,Raymond Felton\feltora01,PG,32,LAC,15,0,249,29,62,.468,12,22,.545,17,40,.425,.565,4,6,.667,3,20,23,20,11,6,13,18,74
123,Yogi Ferrell\ferreyo01,PG,23,BRK,6,0,102,12,30,.400,5,16,.313,7,14,.500,.483,8,12,.667,3,5,8,16,1,1,9,8,37
124,Dorian Finney-Smith\finnedo01,SF,23,DAL,12,7,190,13,35,.371,4,20,.200,9,15,.600,.429,9,11,.818,7,16,23,5,6,2,4,16,39
125,Bryn Forbes\forbebr01,SG,23,SAS,8,0,50,4,12,.333,1,5,.200,3,7,.429,.375,1,1,1.000,0,3,3,1,1,0,0,5,10
126,Evan Fournier\fournev01,SG,24,ORL,14,14,476,80,190,.421,27,74,.365,53,116,.457,.492,49,58,.845,5,37,42,40,13,0,34,36,236
127,Randy Foye\foyera01,SG,33,BRK,7,1,122,11,37,.297,7,25,.280,4,12,.333,.392,6,7,.857,0,14,14,21,1,0,10,9,35
128,Tim Frazier\fraziti01,PG,26,NOP,15,15,461,65,143,.455,14,38,.368,51,105,.486,.503,35,41,.854,8,46,54,120,15,4,35,44,179
129,Channing Frye\fryech01,C,33,CLE,10,0,184,39,92,.424,28,60,.467,11,32,.344,.576,4,4,1.000,6,25,31,7,4,9,8,19,110
130,Danilo Gallinari\gallida01,SF,28,DEN,14,14,507,67,166,.404,25,70,.357,42,96,.438,.479,76,88,.864,8,56,64,29,9,5,20,16,235
131,Langston Galloway\gallola01,PG,25,NOP,15,0,311,53,134,.396,26,67,.388,27,67,.403,.493,10,13,.769,5,37,42,26,17,1,11,23,142
132,Marc Gasol\gasolma01,C,32,MEM,13,13,424,81,199,.407,19,45,.422,62,154,.403,.455,42,54,.778,10,69,79,51,9,19,30,26,223
133,Pau Gasol\gasolpa01,C,36,SAS,14,14,363,72,143,.503,6,14,.429,66,129,.512,.524,21,33,.636,17,83,100,36,4,18,17,26,171
134,Rudy Gay\gayru01,SF,30,SAC,13,13,449,94,196,.480,15,36,.417,79,160,.494,.518,63,77,.818,9,72,81,35,17,12,29,34,266
135,Michael Gbinije\gbinimi01,SG,24,DET,3,0,10,0,3,.000,0,2,.000,0,1,.000,.000,2,2,1.000,0,0,0,1,0,0,0,1,2
136,Alonzo Gee\geeal01,SF,29,DEN,3,0,13,0,1,.000,0,0,,0,1,.000,.000,2,4,.500,1,2,3,1,0,0,0,3,2
137,Paul George\georgpa01,SF,26,IND,11,11,382,84,183,.459,27,67,.403,57,116,.491,.533,36,39,.923,13,65,78,39,19,7,34,28,231
138,Jonathan Gibson\gibsojo01,PG,29,DAL,3,0,67,13,28,.464,5,14,.357,8,14,.571,.554,13,18,.722,1,10,11,8,4,0,10,9,44
139,Taj Gibson\gibsota01,PF,31,CHI,15,15,430,80,152,.526,0,0,,80,152,.526,.526,17,26,.654,42,79,121,21,10,15,26,32,177
140,Manu Ginobili\ginobma01,SG,39,SAS,13,0,249,35,85,.412,17,40,.425,18,45,.400,.512,15,16,.938,4,31,35,30,12,3,20,19,102
141,Rudy Gobert\goberru01,C,24,UTA,15,15,460,53,85,.624,0,0,,53,85,.624,.624,43,68,.632,45,112,157,17,11,35,25,50,149
142,Archie Goodwin\goodwar01,SG,22,NOP,3,0,30,2,5,.400,1,2,.500,1,3,.333,.500,10,10,1.000,0,0,0,1,0,1,0,1,15
143,Aaron Gordon\gordoaa01,SF,21,ORL,14,8,378,54,131,.412,12,40,.300,42,91,.462,.458,20,32,.625,14,51,65,28,16,9,17,28,140
144,Eric Gordon\gordoer01,SG,28,HOU,14,8,446,74,182,.407,40,104,.385,34,78,.436,.516,27,32,.844,6,40,46,35,10,8,26,33,215
145,Marcin Gortat\gortama01,C,32,WAS,13,13,455,61,105,.581,0,0,,61,105,.581,.581,26,41,.634,43,120,163,21,5,16,21,44,148
146,Treveon Graham\grahatr01,SG,23,CHO,3,1,40,2,4,.500,1,2,.500,1,2,.500,.625,0,0,,0,5,5,2,0,0,0,10,5
147,Jerami Grant\grantje01,SF,22,TOT,14,0,254,35,70,.500,8,17,.471,27,53,.509,.557,12,26,.462,2,35,37,4,7,17,8,25,90
147,Jerami Grant\grantje01,SF,22,PHI,2,0,41,6,17,.353,0,2,.000,6,15,.400,.353,4,8,.500,0,7,7,0,0,4,3,5,16
147,Jerami Grant\grantje01,SF,22,OKC,12,0,213,29,53,.547,8,15,.533,21,38,.553,.623,8,18,.444,2,28,30,4,7,13,5,20,74
148,Jerian Grant\grantje02,PG,24,CHI,9,2,126,15,48,.313,4,16,.250,11,32,.344,.354,10,10,1.000,2,14,16,14,11,1,2,9,44
149,Danny Green\greenda02,SG,29,SAS,6,6,152,14,32,.438,9,24,.375,5,8,.625,.578,5,6,.833,1,14,15,17,7,4,4,13,42
150,Draymond Green\greendr01,PF,26,GSW,14,14,467,53,128,.414,15,47,.319,38,81,.469,.473,30,38,.789,26,101,127,96,31,24,26,38,151
151,Gerald Green\greenge01,SG,31,BOS,10,0,109,15,47,.319,7,24,.292,8,23,.348,.394,4,4,1.000,4,16,20,15,1,1,6,11,41
152,JaMychal Green\greenja01,PF,26,MEM,14,14,395,47,99,.475,8,26,.308,39,73,.534,.515,21,26,.808,25,63,88,13,6,10,22,55,123
153,Jeff Green\greenje02,SF,30,ORL,14,6,313,37,106,.349,13,49,.265,24,57,.421,.410,25,30,.833,9,37,46,20,4,6,13,18,112
154,Blake Griffin\griffbl01,PF,27,LAC,15,15,499,116,235,.494,2,15,.133,114,220,.518,.498,94,119,.790,29,110,139,66,19,9,24,44,328
155,Justin Hamilton\hamilju01,C,26,BRK,13,2,303,44,84,.524,23,52,.442,21,32,.656,.661,7,9,.778,14,47,61,9,9,6,9,25,118
156,A.J. Hammons\hammoaj01,C,24,DAL,5,0,15,3,5,.600,1,1,1.000,2,4,.500,.700,2,2,1.000,2,3,5,1,0,2,0,1,9
157,Tim Hardaway\hardati02,SG,24,ATL,14,0,297,63,126,.500,23,64,.359,40,62,.645,.591,21,32,.656,4,24,28,20,4,2,9,8,170
158,James Harden\hardeja01,PG,27,HOU,14,14,514,122,265,.460,42,115,.365,80,150,.533,.540,115,142,.810,22,87,109,173,17,4,75,36,401
159,Maurice Harkless\harklma01,SF,23,POR,16,16,489,77,157,.490,23,59,.390,54,98,.551,.564,11,15,.733,25,58,83,13,10,12,19,38,188
160,Montrezl Harrell\harremo01,PF,23,HOU,6,0,78,17,31,.548,0,0,,17,31,.548,.548,3,5,.600,13,13,26,7,2,4,10,9,37
161,Gary Harris\harriga01,SG,22,DEN,5,4,114,21,46,.457,4,13,.308,17,33,.515,.500,8,12,.667,3,13,16,12,2,1,6,10,54
162,Joe Harris\harrijo01,SG,25,BRK,13,0,312,44,101,.436,19,61,.311,25,40,.625,.530,10,15,.667,4,32,36,19,10,2,18,33,117
163,Tobias Harris\harrito02,PF,24,DET,15,15,489,92,194,.474,16,48,.333,76,146,.521,.515,43,46,.935,7,62,69,22,12,9,26,33,243
164,Aaron Harrison\harriaa01,SG,22,CHO,2,0,6,0,2,.000,0,1,.000,0,1,.000,.000,0,0,,0,1,1,1,0,0,0,1,0
165,Andrew Harrison\harrian01,SG,22,MEM,13,2,314,23,72,.319,8,34,.235,15,38,.395,.375,26,33,.788,4,22,26,40,15,4,20,47,80
166,Udonis Haslem\hasleud01,PF,36,MIA,3,0,20,0,3,.000,0,0,,0,3,.000,.000,0,0,,1,5,6,1,1,0,0,7,0
167,Spencer Hawes\hawessp01,PF,28,CHO,12,0,224,42,86,.488,4,15,.267,38,71,.535,.512,7,9,.778,17,47,64,23,7,11,19,16,95
168,Gordon Hayward\haywago01,SF,26,UTA,9,9,324,61,153,.399,12,49,.245,49,104,.471,.438,43,47,.915,7,61,68,34,5,1,21,19,177
169,Gerald Henderson\hendege02,SG,29,PHI,14,14,352,60,120,.500,11,26,.423,49,94,.521,.546,18,23,.783,8,30,38,20,13,3,13,30,149
170,John Henson\hensojo01,C,26,MIL,12,5,204,23,47,.489,0,0,,23,47,.489,.489,9,15,.600,16,47,63,12,5,12,14,38,55
171,Juan Hernangomez\hernaju01,PF,21,DEN,12,0,134,14,28,.500,6,12,.500,8,16,.500,.607,8,13,.615,5,26,31,6,3,3,5,16,42
172,Willy Hernangomez\hernawi01,C,22,NYK,11,0,142,26,45,.578,0,0,,26,45,.578,.578,5,10,.500,14,29,43,4,4,4,18,16,57
173,Mario Hezonja\hezonma01,SF,21,ORL,9,0,139,20,65,.308,5,28,.179,15,37,.405,.346,5,7,.714,3,17,20,9,4,2,11,8,50
174,Roy Hibbert\hibbero01,C,30,CHO,8,4,119,19,31,.613,0,0,,19,31,.613,.613,9,11,.818,12,13,25,4,1,6,7,17,47
175,Buddy Hield\hieldbu01,SG,23,NOP,15,1,275,49,130,.377,16,66,.242,33,64,.516,.438,8,9,.889,5,33,38,18,6,2,14,21,122
176,Nene Hilario\hilarne01,C,34,HOU,12,0,232,37,62,.597,2,3,.667,35,59,.593,.613,21,34,.618,18,32,50,14,6,7,21,33,97
177,George Hill\hillge01,PG,30,UTA,7,7,237,53,98,.541,16,37,.432,37,61,.607,.622,21,24,.875,3,17,20,34,7,2,8,16,143
178,Jordan Hill\hilljo01,C,29,MIN,2,0,11,2,3,.667,0,0,,2,3,.667,.667,2,2,1.000,3,3,6,0,0,0,2,3,6
179,Solomon Hill\hillso01,SF,25,NOP,15,8,382,22,67,.328,10,30,.333,12,37,.324,.403,22,28,.786,5,46,51,32,16,7,15,42,76
180,Darrun Hilliard\hillida01,SG,23,DET,5,0,38,2,10,.200,1,4,.250,1,6,.167,.250,7,10,.700,0,3,3,8,0,0,1,5,12
181,Jrue Holiday\holidjr01,PG,26,NOP,3,0,80,24,46,.522,4,12,.333,20,34,.588,.565,6,10,.600,0,8,8,20,4,2,7,7,58
182,Justin Holiday\holidju01,SG,27,NYK,14,0,259,32,75,.427,14,32,.438,18,43,.419,.520,10,12,.833,7,30,37,14,7,6,10,20,88
183,Rondae Hollis-Jefferson\holliro01,SF,22,BRK,13,13,333,27,81,.333,4,16,.250,23,65,.354,.358,36,40,.900,6,53,59,36,14,5,22,35,94
184,Richaun Holmes\holmeri01,PF,23,PHI,12,1,182,32,56,.571,5,10,.500,27,46,.587,.616,8,14,.571,14,38,52,11,8,9,9,23,77
185,Rodney Hood\hoodro01,SG,24,UTA,14,14,457,86,191,.450,32,83,.386,54,108,.500,.534,34,45,.756,3,60,63,28,11,4,17,39,238
186,Al Horford\horfoal01,C,30,BOS,5,5,158,31,59,.525,6,17,.353,25,42,.595,.576,6,8,.750,7,26,33,24,4,13,5,13,74
187,Danuel House\houseda01,SG,23,WAS,1,0,1,0,0,,0,0,,0,0,,,0,0,,0,1,1,0,0,0,0,0,0
188,Dwight Howard\howardw01,C,31,ATL,13,13,361,70,116,.603,0,0,,70,116,.603,.603,44,91,.484,59,107,166,15,17,24,29,45,184
189,Marcelo Huertas\huertma01,PG,33,LAL,3,0,22,2,8,.250,0,2,.000,2,6,.333,.250,0,0,,1,3,4,8,0,1,2,0,4
190,Kris Humphries\humphkr01,PF,31,ATL,13,0,140,15,37,.405,4,12,.333,11,25,.440,.459,13,14,.929,11,30,41,9,3,8,10,14,47
191,R.J. Hunter\hunterj01,SG,23,CHI,1,0,4,0,1,.000,0,1,.000,0,0,,.000,0,0,,0,0,0,0,0,0,0,0,0
192,Serge Ibaka\ibakase01,PF,27,ORL,14,14,418,79,167,.473,18,38,.474,61,129,.473,.527,25,29,.862,28,68,96,9,4,20,22,36,201
193,Andre Iguodala\iguodan01,SF,33,GSW,14,0,338,31,71,.437,11,35,.314,20,36,.556,.514,6,10,.600,6,36,42,49,16,4,8,19,79
194,Ersan Ilyasova\ilyaser01,PF,29,TOT,14,4,334,55,126,.437,24,64,.375,31,62,.500,.532,16,18,.889,10,60,70,18,7,2,16,30,150
194,Ersan Ilyasova\ilyaser01,PF,29,OKC,3,0,62,6,16,.375,3,12,.250,3,4,.750,.469,0,0,,2,14,16,1,3,1,4,5,15
194,Ersan Ilyasova\ilyaser01,PF,29,PHI,11,4,272,49,110,.445,21,52,.404,28,58,.483,.541,16,18,.889,8,46,54,17,4,1,12,25,135
195,Joe Ingles\inglejo01,SF,29,UTA,15,1,249,25,55,.455,13,31,.419,12,24,.500,.573,10,13,.769,2,22,24,22,11,1,12,26,73
196,Brandon Ingram\ingrabr01,SF,19,LAL,15,0,337,35,87,.402,8,27,.296,27,60,.450,.448,27,36,.750,7,40,47,25,8,6,18,23,105
197,Kyrie Irving\irvinky01,PG,24,CLE,12,12,406,112,239,.469,30,75,.400,82,164,.500,.531,34,41,.829,9,31,40,60,9,3,27,28,288
198,Demetrius Jackson\jacksde01,PG,22,BOS,3,0,15,3,4,.750,1,1,1.000,2,3,.667,.875,3,6,.500,2,1,3,2,0,0,0,0,10
199,LeBron James\jamesle01,SF,32,CLE,11,11,398,94,188,.500,17,49,.347,77,139,.554,.545,50,71,.704,13,79,92,99,11,7,39,21,255
200,Al Jefferson\jeffeal01,C,32,IND,15,1,220,43,95,.453,0,1,.000,43,94,.457,.453,6,9,.667,17,50,67,15,3,6,10,30,92
201,Richard Jefferson\jefferi01,SF,36,CLE,12,2,224,18,46,.391,6,22,.273,12,24,.500,.457,6,10,.600,3,29,32,10,4,1,7,18,48
202,John Jenkins\jenkijo01,SG,25,PHO,2,0,6,0,2,.000,0,1,.000,0,1,.000,.000,2,2,1.000,0,1,1,0,0,0,0,0,2
203,Brandon Jennings\jennibr01,PG,27,NYK,14,0,301,32,86,.372,13,44,.295,19,42,.452,.448,17,23,.739,9,35,44,73,13,0,19,24,94
204,Jonas Jerebko\jerebjo01,PF,29,BOS,14,0,248,23,56,.411,9,24,.375,14,32,.438,.491,6,8,.750,10,36,46,9,10,5,8,28,61
205,Amir Johnson\johnsam01,PF,29,BOS,14,14,311,39,72,.542,6,13,.462,33,59,.559,.583,15,18,.833,22,35,57,32,9,9,16,38,99
206,James Johnson\johnsja01,PF,29,MIA,13,0,294,43,88,.489,13,36,.361,30,52,.577,.563,20,26,.769,13,46,59,22,8,12,21,26,119
207,Joe Johnson\johnsjo02,SF,35,UTA,15,6,374,55,119,.462,19,42,.452,36,77,.468,.542,15,17,.882,6,46,52,33,9,2,9,13,144
208,Stanley Johnson\johnsst04,SF,20,DET,14,0,221,21,55,.382,6,21,.286,15,34,.441,.436,10,16,.625,5,28,33,13,7,6,8,20,58
209,Tyler Johnson\johnsty01,SG,24,MIA,13,0,382,52,123,.423,15,36,.417,37,87,.425,.484,28,38,.737,9,56,65,37,13,6,16,27,147
210,Wesley Johnson\johnswe01,SF,29,LAC,10,0,139,11,36,.306,6,22,.273,5,14,.357,.389,1,1,1.000,7,30,37,3,4,7,4,20,29
211,Nikola Jokic\jokicni01,PF,21,DEN,14,8,316,50,101,.495,4,18,.222,46,83,.554,.515,19,25,.760,23,62,85,33,11,5,19,44,123
212,Derrick Jones\jonesde02,SF,19,PHO,1,0,3,0,0,,0,0,,0,0,,,0,0,,0,0,0,0,0,0,0,0,0
213,James Jones\jonesja02,SF,36,CLE,5,0,11,3,6,.500,2,4,.500,1,2,.500,.667,2,2,1.000,0,1,1,0,0,0,1,1,10
214,Terrence Jones\joneste01,PF,25,NOP,14,3,343,59,127,.465,6,28,.214,53,99,.535,.488,26,39,.667,14,64,78,20,15,18,15,19,150
215,Tyus Jones\jonesty01,PG,20,MIN,9,0,146,12,33,.364,7,18,.389,5,15,.333,.470,14,15,.933,5,14,19,31,10,0,8,10,45
216,DeAndre Jordan\jordade01,C,28,LAC,15,15,462,63,105,.600,0,0,,63,105,.600,.600,36,75,.480,48,138,186,8,7,24,25,45,162
217,Cory Joseph\josepco01,SG,25,TOR,14,0,277,35,86,.407,5,18,.278,30,68,.441,.436,20,27,.741,6,24,30,29,13,1,16,21,95
218,Frank Kaminsky\kaminfr01,C,23,CHO,11,0,262,53,112,.473,17,51,.333,36,61,.590,.549,7,11,.636,6,36,42,27,7,6,13,18,130
219,Enes Kanter\kanteen01,C,24,OKC,15,0,279,73,130,.562,2,11,.182,71,119,.597,.569,33,39,.846,30,63,93,9,6,11,23,31,181
220,Ryan Kelly\kellyry01,PF,25,ATL,4,0,20,1,5,.200,0,1,.000,1,4,.250,.200,2,2,1.000,0,2,2,2,1,1,0,2,4
221,Michael Kidd-Gilchrist\kiddgmi01,SF,23,CHO,12,12,381,37,86,.430,0,3,.000,37,83,.446,.430,31,45,.689,24,75,99,17,14,13,10,30,105
222,Sean Kilpatrick\kilpase01,SG,27,BRK,13,4,322,58,148,.392,18,57,.316,40,91,.440,.453,41,51,.804,6,52,58,28,11,0,33,24,175
223,Brandon Knight\knighbr03,SG,25,PHO,15,2,373,66,176,.375,16,51,.314,50,125,.400,.420,39,44,.886,7,35,42,48,9,0,34,26,187
224,Kyle Korver\korveky01,SG,35,ATL,13,13,362,48,97,.495,27,61,.443,21,36,.583,.634,6,6,1.000,0,32,32,29,12,6,24,22,129
225,Kosta Koufos\koufoko01,C,27,SAC,14,12,277,33,69,.478,0,1,.000,33,68,.485,.478,6,14,.429,22,61,83,11,5,8,16,30,72
226,Mindaugas Kuzminskas\kuzmimi01,SF,27,NYK,11,0,111,19,41,.463,8,19,.421,11,22,.500,.561,4,6,.667,8,11,19,7,5,0,4,9,50
227,Skal Labissiere\labissk01,PF,20,SAC,1,0,15,3,5,.600,0,0,,3,5,.600,.600,2,3,.667,3,0,3,0,0,0,0,0,8
228,Jeremy Lamb\lambje01,SG,24,CHO,3,0,41,9,23,.391,0,6,.000,9,17,.529,.391,3,4,.750,2,10,12,3,1,1,0,5,21
229,Nicolas Laprovittola\laproni01,PG,27,SAS,8,0,82,8,21,.381,4,13,.308,4,8,.500,.476,5,5,1.000,1,6,7,12,1,0,8,8,25
230,Joffrey Lauvergne\lauvejo01,C,25,OKC,13,0,198,29,63,.460,10,26,.385,19,37,.514,.540,2,5,.400,12,35,47,12,7,3,6,25,70
231,Zach LaVine\lavinza01,SG,21,MIN,12,12,424,80,176,.455,33,82,.402,47,94,.500,.548,28,32,.875,4,34,38,30,10,3,15,22,221
232,Ty Lawson\lawsoty01,PG,29,SAC,14,13,399,32,91,.352,11,31,.355,21,60,.350,.412,13,20,.650,11,32,43,73,16,1,19,25,88
233,Jake Layman\laymaja01,SF,22,POR,8,0,68,14,30,.467,8,22,.364,6,8,.750,.600,4,5,.800,0,9,9,5,3,1,3,11,40
234,Courtney Lee\leeco01,SG,31,NYK,14,14,422,51,123,.415,14,37,.378,37,86,.430,.472,9,10,.900,7,36,43,24,13,5,15,27,125
235,David Lee\leeda02,PF,33,SAS,14,1,236,37,62,.597,0,0,,37,62,.597,.597,17,23,.739,22,41,63,19,9,5,7,24,91
236,Alex Len\lenal01,C,23,PHO,15,7,337,49,101,.485,0,1,.000,49,100,.490,.485,35,53,.660,31,87,118,14,9,20,17,52,133
237,Kawhi Leonard\leonaka01,SF,25,SAS,14,14,473,111,246,.451,28,68,.412,83,178,.466,.508,97,103,.942,16,74,90,42,32,6,27,24,347
238,Meyers Leonard\leoname01,PF,24,POR,14,3,222,27,77,.351,14,46,.304,13,31,.419,.442,10,10,1.000,4,40,44,14,2,4,9,30,78
239,Jon Leuer\leuerjo01,PF,27,DET,15,0,397,62,132,.470,10,35,.286,52,97,.536,.508,21,23,.913,27,77,104,19,5,10,11,31,155
240,DeAndre Liggins\liggide01,SG,28,CLE,6,0,53,4,8,.500,0,0,,4,8,.500,.500,4,4,1.000,2,7,9,6,2,1,4,7,12
241,Damian Lillard\lillada01,PG,26,POR,16,16,566,141,307,.459,39,112,.348,102,195,.523,.523,121,135,.896,12,65,77,73,14,3,49,41,442
242,Jeremy Lin\linje01,PG,28,BRK,5,5,134,26,58,.448,6,19,.316,20,39,.513,.500,17,22,.773,2,17,19,31,7,3,12,2,75
243,Shaun Livingston\livinsh01,PG,31,GSW,14,0,240,27,46,.587,0,1,.000,27,45,.600,.587,9,17,.529,10,18,28,26,6,2,11,24,63
244,Kevon Looney\looneke01,PF,20,GSW,12,0,92,14,22,.636,0,0,,14,22,.636,.636,7,13,.538,11,20,31,8,1,5,3,18,35
245,Brook Lopez\lopezbr01,C,28,BRK,11,11,294,82,168,.488,22,60,.367,60,108,.556,.554,42,50,.840,19,39,58,17,5,19,27,22,228
246,Robin Lopez\lopezro01,C,28,CHI,15,15,422,68,147,.463,0,1,.000,68,146,.466,.463,10,15,.667,58,61,119,12,2,25,8,30,146
247,Kevin Love\loveke01,PF,28,CLE,12,12,387,78,182,.429,18,57,.316,60,125,.480,.478,69,83,.831,36,96,132,16,11,8,26,26,243
248,Kyle Lowry\lowryky01,PG,30,TOR,14,14,542,92,234,.393,33,98,.337,59,136,.434,.464,61,72,.847,18,59,77,101,24,6,45,46,278
249,John Lucas III\lucasjo02,PG,34,MIN,5,0,11,1,4,.250,0,1,.000,1,3,.333,.250,0,0,,0,0,0,1,2,0,0,0,2
250,Timothe Luwawu-Cabarrot\luwawti01,SF,21,PHI,9,0,46,6,16,.375,1,3,.333,5,13,.385,.406,2,4,.500,1,3,4,2,1,0,3,3,15
251,Trey Lyles\lylestr01,PF,21,UTA,15,2,352,49,130,.377,15,57,.263,34,73,.466,.435,18,21,.857,12,55,67,19,7,6,16,22,131
252,Shelvin Mack\macksh01,PG,26,UTA,15,2,299,45,106,.425,9,29,.310,36,77,.468,.467,8,13,.615,5,26,31,40,11,0,26,27,107
253,Thon Maker\makerth01,PF,19,MIL,4,0,13,3,5,.600,2,3,.667,1,2,.500,.800,1,2,.500,2,5,7,0,0,0,0,2,9
254,Boban Marjanovic\marjabo01,C,28,DET,6,0,37,6,19,.316,0,0,,6,19,.316,.316,5,5,1.000,4,9,13,0,1,3,1,6,17
255,Jarell Martin\martija01,PF,22,MEM,13,2,159,16,40,.400,3,9,.333,13,31,.419,.438,14,19,.737,11,22,33,1,4,5,12,28,49
256,Wesley Matthews\matthwe02,SG,30,DAL,12,12,443,51,155,.329,30,96,.313,21,59,.356,.426,28,33,.848,5,34,39,26,17,1,19,31,160
257,Luc Mbah a Moute\mbahalu01,PF,30,LAC,15,15,356,36,66,.545,10,23,.435,26,43,.605,.621,12,24,.500,12,23,35,4,18,7,11,18,94
258,James Michael McAdoo\mcadoja01,PF,24,GSW,6,0,40,3,11,.273,0,1,.000,3,10,.300,.273,1,2,.500,1,3,4,2,0,1,0,0,7
259,Patrick McCaw\mccawpa01,SG,21,GSW,9,0,137,15,36,.417,7,20,.350,8,16,.500,.514,2,2,1.000,2,7,9,10,5,5,3,13,39
260,Sheldon McClellan\mcclesh01,SG,24,WAS,6,2,76,12,27,.444,2,10,.200,10,17,.588,.481,6,7,.857,2,3,5,3,4,0,1,5,32
261,C.J. McCollum\mccolcj01,SG,25,POR,16,16,552,134,282,.475,40,88,.455,94,194,.485,.546,51,57,.895,14,53,67,56,19,8,40,54,359
262,T.J. McConnell\mccontj01,PG,24,PHI,14,0,271,23,51,.451,1,10,.100,22,41,.537,.461,7,11,.636,5,24,29,66,21,0,21,24,54
263,Chris McCullough\mcculch01,PF,21,BRK,5,0,33,8,17,.471,1,3,.333,7,14,.500,.500,0,0,,7,2,9,1,0,2,1,4,17
264,K.J. McDaniels\mcdankj01,SF,23,HOU,11,0,148,21,41,.512,6,19,.316,15,22,.682,.585,4,4,1.000,3,13,16,2,4,6,5,13,52
265,Doug McDermott\mcderdo01,SF,25,CHI,9,0,213,37,72,.514,8,22,.364,29,50,.580,.569,13,15,.867,1,23,24,12,3,1,6,12,95
266,JaVale McGee\mcgeeja01,C,29,GSW,10,0,64,18,28,.643,0,0,,18,28,.643,.643,6,13,.462,5,9,14,2,0,7,7,11,42
267,Rodney McGruder\mcgruro01,SG,25,MIA,12,1,217,21,50,.420,8,25,.320,13,25,.520,.500,8,14,.571,13,17,30,9,8,2,4,19,58
268,Ben McLemore\mclembe01,SG,23,SAC,12,0,205,32,71,.451,8,23,.348,24,48,.500,.507,11,14,.786,3,14,17,10,3,2,11,14,83
269,Jordan McRae\mcraejo01,SG,25,CLE,7,0,71,7,28,.250,3,6,.500,4,22,.182,.304,3,4,.750,0,5,5,6,1,1,3,5,20
270,Josh McRoberts\mcrobjo01,PF,29,MIA,4,0,48,3,17,.176,0,3,.000,3,14,.214,.176,0,0,,4,8,12,5,2,1,2,6,6
271,Salah Mejri\mejrisa01,C,30,DAL,10,1,119,16,20,.800,0,0,,16,20,.800,.800,3,5,.600,7,31,38,2,5,8,5,23,35
272,Jordan Mickey\mickejo01,PF,22,BOS,8,0,66,8,17,.471,0,0,,8,17,.471,.471,2,5,.400,5,9,14,3,1,0,4,8,18
273,C.J. Miles\milescj01,SF,29,IND,13,3,297,60,122,.492,30,62,.484,30,60,.500,.615,19,21,.905,5,30,35,10,13,9,6,24,169
274,Mike Miller\millemi01,SF,36,DEN,3,0,13,3,4,.750,3,4,.750,0,0,,1.125,0,0,,0,2,2,2,0,0,1,1,9
275,Patrick Mills\millspa02,PG,28,SAS,14,4,334,53,111,.477,26,65,.400,27,46,.587,.595,18,19,.947,7,20,27,49,8,0,16,21,150
276,Paul Millsap\millspa01,PF,31,ATL,14,14,455,90,198,.455,14,41,.341,76,157,.484,.490,43,60,.717,19,92,111,52,23,10,34,39,237
277,Nikola Mirotic\mirotni01,PF,25,CHI,15,1,343,48,120,.400,24,75,.320,24,45,.533,.500,28,38,.737,9,76,85,16,6,11,18,20,148
278,Greg Monroe\monrogr01,C,26,MIL,12,0,211,35,79,.443,0,1,.000,35,78,.449,.443,31,34,.912,22,53,75,28,15,6,16,18,101
279,E'Twaun Moore\mooreet01,SG,27,NOP,14,14,401,68,151,.450,15,44,.341,53,107,.495,.500,16,19,.842,6,23,29,42,14,4,18,29,167
280,Marcus Morris\morrima03,SF,27,DET,15,15,484,84,198,.424,21,66,.318,63,132,.477,.477,21,24,.875,16,47,63,31,14,4,12,28,210
281,Markieff Morris\morrima02,PF,27,WAS,13,13,399,62,153,.405,12,31,.387,50,122,.410,.444,33,41,.805,19,64,83,16,15,9,26,34,169
282,Anthony Morrow\morroan01,SG,31,OKC,9,0,62,11,26,.423,0,10,.000,11,16,.688,.423,1,2,.500,2,2,4,3,3,1,2,4,23
283,Timofey Mozgov\mozgoti01,C,30,LAL,14,14,310,52,85,.612,0,1,.000,52,84,.619,.612,18,20,.900,29,37,66,15,5,10,18,32,122
284,Emmanuel Mudiay\mudiaem01,PG,20,DEN,14,14,453,73,201,.363,15,57,.263,58,144,.403,.400,50,60,.833,9,62,71,58,17,4,53,32,211
285,Shabazz Muhammad\muhamsh01,SF,24,MIN,10,0,171,25,55,.455,3,9,.333,22,46,.478,.482,16,19,.842,9,13,22,4,3,1,8,11,69
286,Dejounte Murray\murrade01,PG,20,SAS,9,1,41,4,13,.308,2,3,.667,2,10,.200,.385,2,4,.500,0,5,5,7,0,0,7,7,12
287,Jamal Murray\murraja01,SG,19,DEN,14,3,284,45,110,.409,22,52,.423,23,58,.397,.509,14,18,.778,6,26,32,30,6,2,17,21,126
288,Mike Muscala\muscami01,C,25,ATL,14,1,297,50,86,.581,9,26,.346,41,60,.683,.634,20,25,.800,22,42,64,24,7,9,16,27,129
289,Larry Nance Jr.\nancela02,PF,24,LAL,14,0,301,45,74,.608,1,7,.143,44,67,.657,.615,10,13,.769,17,52,69,17,19,6,7,23,101
290,Shabazz Napier\napiesh01,PG,25,POR,10,0,68,10,25,.400,6,19,.316,4,6,.667,.520,6,11,.545,0,7,7,11,6,0,5,7,32
291,Maurice Ndour\ndourma01,PF,24,NYK,8,0,76,9,17,.529,0,2,.000,9,15,.600,.529,5,6,.833,3,12,15,0,3,2,2,11,23
292,Jameer Nelson\nelsoja01,PG,34,DEN,14,2,355,46,101,.455,17,43,.395,29,58,.500,.540,6,6,1.000,4,32,36,53,8,1,30,45,115
293,Raul Neto\netora01,PG,24,UTA,5,0,12,2,5,.400,1,2,.500,1,3,.333,.500,1,1,1.000,0,2,2,2,0,0,1,1,6
294,Georges Niang\niangge01,PF,23,IND,10,0,61,2,20,.100,0,6,.000,2,14,.143,.100,2,2,1.000,2,11,13,5,0,0,4,5,6
295,Andrew Nicholson\nichoan01,PF,27,WAS,9,0,100,17,37,.459,1,6,.167,16,31,.516,.473,3,7,.429,6,11,17,1,6,2,4,14,38
296,Joakim Noah\noahjo01,C,31,NYK,12,12,281,23,51,.451,0,1,.000,23,50,.460,.451,6,19,.316,40,67,107,42,10,10,17,28,52
297,Lucas Nogueira\noguelu01,C,24,TOR,8,0,150,15,19,.789,0,0,,15,19,.789,.789,4,6,.667,12,26,38,5,8,14,5,23,34
298,Steve Novak\novakst01,PF,33,MIL,1,0,4,0,1,.000,0,1,.000,0,0,,.000,0,0,,0,0,0,0,0,0,0,0,0
299,Dirk Nowitzki\nowitdi01,PF,38,DAL,3,3,83,14,39,.359,4,14,.286,10,25,.400,.410,4,4,1.000,1,19,20,3,3,3,3,4,36
300,Jusuf Nurkic\nurkiju01,C,22,DEN,14,14,326,63,125,.504,0,0,,63,125,.504,.504,26,49,.531,38,74,112,23,10,16,33,30,152
301,Kyle O'Quinn\oquinky01,PF,26,NYK,14,2,163,27,51,.529,0,2,.000,27,49,.551,.529,11,15,.733,19,28,47,9,5,16,13,24,65
302,Daniel Ochefu\ochefda01,C,23,WAS,3,0,8,1,3,.333,0,0,,1,3,.333,.333,0,0,,0,3,3,0,0,0,1,2,2
303,Jahlil Okafor\okafoja01,C,21,PHI,13,3,259,60,120,.500,0,0,,60,120,.500,.500,21,37,.568,13,32,45,13,4,14,14,30,141
304,Victor Oladipo\oladivi01,SG,24,OKC,15,15,516,97,217,.447,33,79,.418,64,138,.464,.523,23,33,.697,10,51,61,38,13,4,30,29,250
305,Kelly Olynyk\olynyke01,C,25,BOS,8,5,191,22,56,.393,8,28,.286,14,28,.500,.464,8,10,.800,5,33,38,13,1,1,11,22,60
306,Arinze Onuaku\onuakar01,C,29,ORL,2,0,10,0,0,,0,0,,0,0,,,0,0,,0,1,1,0,0,1,0,1,0
307,Kelly Oubre\oubreke01,SF,21,WAS,12,0,175,21,51,.412,7,21,.333,14,30,.467,.480,6,11,.545,4,19,23,6,4,1,6,20,55
308,Zaza Pachulia\pachuza01,C,32,GSW,14,14,238,25,47,.532,0,0,,25,47,.532,.532,14,15,.933,31,57,88,32,9,3,18,25,64
309,Georgios Papagiannis\papagge01,C,19,SAC,1,0,6,1,1,1.000,0,0,,1,1,1.000,1.000,0,0,,0,1,1,0,0,0,1,3,2
310,Jabari Parker\parkeja01,SF,21,MIL,13,13,429,99,214,.463,15,39,.385,84,175,.480,.498,43,53,.811,24,56,80,30,16,4,21,24,256
311,Tony Parker\parketo01,PG,34,SAS,9,9,233,34,74,.459,3,8,.375,31,66,.470,.480,15,19,.789,2,17,19,43,4,1,11,17,86
312,Chandler Parsons\parsoch01,SF,28,MEM,6,6,126,18,46,.391,5,21,.238,13,25,.520,.446,5,6,.833,2,16,18,5,2,2,8,5,46
313,Patrick Patterson\pattepa01,PF,27,TOR,14,0,429,32,99,.323,17,64,.266,15,35,.429,.409,12,16,.750,14,64,78,28,13,8,9,36,93
314,Chris Paul\paulch01,PG,31,LAC,15,15,463,86,185,.465,34,78,.436,52,107,.486,.557,70,80,.875,9,69,78,132,44,3,32,34,276
315,Adreian Payne\paynead01,PF,25,MIN,6,0,55,12,24,.500,2,8,.250,10,16,.625,.542,11,13,.846,5,6,11,3,4,4,3,13,37
316,Elfrid Payton\paytoel01,PG,22,ORL,14,14,420,62,147,.422,7,36,.194,55,111,.495,.446,16,27,.593,7,49,56,77,17,11,26,24,147
317,Paul Pierce\piercpa01,SF,39,LAC,2,0,17,4,6,.667,3,5,.600,1,1,1.000,.917,0,0,,0,0,0,1,0,0,0,3,11
318,Marshall Plumlee\plumlma02,C,24,NYK,1,0,5,0,0,,0,0,,0,0,,,0,0,,0,1,1,0,0,0,0,1,0
319,Mason Plumlee\plumlma01,C,26,POR,16,16,427,59,112,.527,0,1,.000,59,111,.532,.527,25,49,.510,28,79,107,72,13,15,27,40,143
320,Miles Plumlee\plumlmi01,C,28,MIL,13,8,170,15,32,.469,0,0,,15,32,.469,.469,13,18,.722,16,19,35,13,7,5,13,33,43
321,Jakob Poeltl\poeltja01,C,21,TOR,8,2,132,12,26,.462,0,0,,12,26,.462,.462,6,8,.750,18,19,37,2,4,4,3,28,30
322,Otto Porter\porteot01,SF,23,WAS,13,13,447,76,152,.500,17,47,.362,59,105,.562,.556,19,24,.792,35,72,107,20,22,9,10,32,188
323,Bobby Portis\portibo01,PF,21,CHI,14,0,153,25,49,.510,3,6,.500,22,43,.512,.541,7,11,.636,18,24,42,8,1,2,6,19,60
324,Kristaps Porzingis\porzikr01,PF,21,NYK,14,14,461,109,217,.502,30,77,.390,79,140,.564,.571,46,59,.780,27,75,102,16,10,15,18,53,294
325,Dwight Powell\poweldw01,PF,25,DAL,13,1,256,26,67,.388,1,5,.200,25,62,.403,.396,13,20,.650,17,46,63,6,20,9,6,22,66
326,Norman Powell\powelno01,SG,23,TOR,12,3,182,24,52,.462,11,25,.440,13,27,.481,.567,18,22,.818,1,23,24,14,5,1,7,24,77
327,Tim Quarterman\quartti01,SG,22,POR,4,0,14,4,4,1.000,0,0,,4,4,1.000,1.000,0,0,,2,0,2,3,0,0,0,1,8
328,Julius Randle\randlju01,PF,22,LAL,15,15,415,78,147,.531,3,12,.250,75,135,.556,.541,41,55,.745,21,100,121,58,11,9,44,47,200
329,Zach Randolph\randoza01,PF,35,MEM,14,0,307,86,175,.491,4,14,.286,82,161,.509,.503,26,34,.765,26,85,111,14,6,0,21,26,202
330,J.J. Redick\redicjj01,SG,32,LAC,15,15,394,77,157,.490,37,75,.493,40,82,.488,.608,40,44,.909,2,26,28,16,16,3,22,20,231
331,Willie Reed\reedwi02,PF,26,MIA,10,0,125,17,26,.654,0,0,,17,26,.654,.654,6,12,.500,15,14,29,4,1,3,4,13,40
332,Josh Richardson\richajo01,SG,23,MIA,9,6,260,39,102,.382,15,46,.326,24,56,.429,.456,6,9,.667,6,20,26,13,8,7,12,23,99
333,Malachi Richardson\richama01,SG,21,SAC,2,0,8,1,4,.250,1,3,.333,0,1,.000,.375,0,0,,0,0,0,0,0,0,0,1,3
334,Austin Rivers\riverau01,SG,24,LAC,15,0,333,43,108,.398,7,33,.212,36,75,.480,.431,12,21,.571,1,24,25,32,8,4,14,37,105
335,Andre Roberson\roberan03,SF,25,OKC,15,15,438,40,95,.421,12,39,.308,28,56,.500,.484,5,22,.227,17,58,75,18,21,15,10,37,97
336,Brian Roberts\roberbr01,PG,31,CHO,2,0,8,1,4,.250,0,2,.000,1,2,.500,.250,1,2,.500,1,2,3,1,0,0,0,0,3
337,Glenn Robinson\robingl02,SF,23,IND,13,2,213,27,70,.386,6,23,.261,21,47,.447,.429,7,11,.636,9,26,35,9,5,3,7,9,67
338,Thomas Robinson\robinth01,PF,25,LAL,6,0,22,2,5,.400,0,0,,2,5,.400,.400,0,0,,3,3,6,1,0,1,0,3,4
339,Sergio Rodriguez\rodrise01,PG,30,PHI,14,14,396,45,122,.369,15,55,.273,30,67,.448,.430,4,5,.800,5,42,47,100,13,3,38,15,109
340,Rajon Rondo\rondora01,PG,30,CHI,13,13,398,43,118,.364,6,22,.273,37,96,.385,.390,10,16,.625,14,72,86,93,16,4,34,27,102
341,Derrick Rose\rosede01,PG,28,NYK,14,14,443,90,203,.443,6,21,.286,84,182,.462,.458,35,40,.875,15,41,56,67,9,6,41,25,221
342,Terrence Ross\rosste01,SF,25,TOR,13,0,262,48,97,.495,19,43,.442,29,54,.537,.593,15,16,.938,2,26,28,8,16,1,8,22,130
343,Terry Rozier\roziete01,PG,22,BOS,14,0,270,34,79,.430,16,35,.457,18,44,.409,.532,14,20,.700,6,44,50,25,8,3,8,14,98
344,Ricky Rubio\rubiori01,PG,26,MIN,8,8,253,13,43,.302,5,20,.250,8,23,.348,.360,19,28,.679,14,25,39,58,9,0,17,23,50
345,Damjan Rudez\rudezda01,SF,30,ORL,8,0,85,6,14,.429,5,11,.455,1,3,.333,.607,0,0,,3,5,8,2,4,0,5,6,17
346,Brandon Rush\rushbr01,SG,31,MIN,6,0,78,5,20,.250,3,11,.273,2,9,.222,.325,1,2,.500,0,9,9,4,1,2,4,2,14
347,D'Angelo Russell\russeda01,PG,20,LAL,13,13,348,74,179,.413,32,86,.372,42,93,.452,.503,29,38,.763,7,37,44,63,16,4,39,30,209
348,Domantas Sabonis\sabondo01,PF,20,OKC,15,15,331,42,98,.429,17,43,.395,25,55,.455,.515,1,2,.500,6,46,52,22,8,5,18,41,102
349,Dario Saric\saricda01,PF,22,PHI,14,10,364,53,133,.398,18,43,.419,35,90,.389,.466,15,20,.750,11,76,87,25,8,3,27,28,139
350,Tomas Satoransky\satorto01,SG,25,WAS,13,2,247,27,57,.474,2,10,.200,25,47,.532,.491,11,17,.647,6,21,27,37,7,0,14,23,67
351,Dennis Schroder\schrode01,PG,23,ATL,14,14,412,75,175,.429,18,51,.353,57,124,.460,.480,35,47,.745,6,39,45,81,8,1,43,16,203
352,Luis Scola\scolalu01,PF,36,BRK,12,0,184,28,57,.491,5,20,.250,23,37,.622,.535,9,15,.600,19,38,57,17,6,1,16,27,70
353,Thabo Sefolosha\sefolth01,SF,32,ATL,11,1,262,36,66,.545,6,20,.300,30,46,.652,.591,8,12,.667,11,34,45,20,27,2,13,11,86
354,Kevin Seraphin\serapke01,PF,27,IND,11,0,106,22,44,.500,0,0,,22,44,.500,.500,2,4,.500,16,23,39,6,3,4,5,12,46
355,Ramon Sessions\sessira01,PG,30,CHO,13,0,223,20,65,.308,3,16,.188,17,49,.347,.331,18,29,.621,3,15,18,46,7,2,13,12,61
356,Iman Shumpert\shumpim01,SG,26,CLE,12,1,284,28,58,.483,14,31,.452,14,27,.519,.603,14,17,.824,8,22,30,25,15,4,19,26,84
357,Pascal Siakam\siakapa01,PF,22,TOR,14,14,257,37,68,.544,0,0,,37,68,.544,.544,3,4,.750,20,37,57,4,9,8,7,38,77
358,Jonathon Simmons\simmojo02,SG,27,SAS,14,1,272,28,70,.400,3,17,.176,25,53,.472,.421,21,30,.700,5,30,35,28,8,5,12,22,80
359,Kyle Singler\singlky01,SF,28,OKC,9,0,118,8,28,.286,2,16,.125,6,12,.500,.321,3,4,.750,1,13,14,1,1,2,5,12,21
360,Marcus Smart\smartma01,PG,22,BOS,11,5,352,44,118,.373,19,58,.328,25,60,.417,.453,8,17,.471,9,40,49,38,15,5,22,21,115
361,Ish Smith\smithis01,PG,28,DET,15,15,449,63,163,.387,4,16,.250,59,147,.401,.399,17,23,.739,5,38,43,99,19,6,29,24,147
362,J.R. Smith\smithjr01,SG,31,CLE,9,9,280,30,87,.345,27,72,.375,3,15,.200,.500,6,6,1.000,4,17,21,13,16,5,4,20,93
363,Jason Smith\smithja02,C,30,WAS,12,0,127,11,27,.407,0,0,,11,27,.407,.407,2,2,1.000,8,20,28,4,2,5,15,27,24
364,Tony Snell\snellto01,SF,25,MIL,12,12,345,40,97,.412,19,64,.297,21,33,.636,.510,3,4,.750,9,39,48,15,6,1,12,21,102
365,Marreese Speights\speigma01,C,29,LAC,15,0,229,44,104,.423,16,50,.320,28,54,.519,.500,32,39,.821,16,47,63,10,4,8,7,39,136
366,Nik Stauskas\stausni01,SG,23,PHI,14,0,335,49,91,.538,23,50,.460,26,41,.634,.665,19,23,.826,4,32,36,14,7,4,24,20,140
367,Lance Stephenson\stephla01,SG,26,NOP,6,0,162,26,55,.473,1,10,.100,25,45,.556,.482,5,8,.625,3,16,19,29,2,1,11,18,58
368,Jarnell Stokes\stokeja01,PF,23,DEN,2,0,7,1,1,1.000,0,0,,1,1,1.000,1.000,1,2,.500,1,1,2,2,1,0,0,3,3
369,Diamond Stone\stonedi01,C,19,LAC,3,0,14,2,7,.286,0,0,,2,7,.286,.286,2,2,1.000,1,2,3,0,0,1,1,4,6
370,Rodney Stuckey\stuckro01,PG,30,IND,5,0,80,14,32,.438,2,7,.286,12,25,.480,.469,9,15,.600,1,8,9,5,1,0,7,6,39
371,Walter Tavares\tavarwa01,C,24,ATL,1,0,4,1,1,1.000,0,0,,1,1,1.000,1.000,0,2,.000,0,1,1,0,0,0,0,0,2
372,Jeff Teague\teaguje01,PG,28,IND,15,15,479,77,185,.416,15,53,.283,62,132,.470,.457,66,77,.857,6,46,52,96,28,9,42,34,235
373,Mirza Teletovic\teletmi01,PF,31,MIL,13,1,210,30,77,.390,23,60,.383,7,17,.412,.539,7,10,.700,4,25,29,8,2,3,7,24,90
374,Garrett Temple\templga01,SG,30,SAC,14,0,275,29,63,.460,13,32,.406,16,31,.516,.563,7,8,.875,6,28,34,25,9,7,10,17,78
375,Jason Terry\terryja01,SG,39,MIL,8,0,145,11,27,.407,6,16,.375,5,11,.455,.519,4,4,1.000,1,10,11,11,5,1,3,9,32
376,Isaiah Thomas\thomais02,PG,27,BOS,14,14,463,110,252,.437,28,89,.315,82,163,.503,.492,122,139,.878,9,31,40,88,12,2,35,35,370
377,Lance Thomas\thomala01,PF,28,NYK,8,0,140,14,37,.378,3,8,.375,11,29,.379,.419,0,0,,3,16,19,3,5,1,5,12,31
378,Hollis Thompson\thompho01,SG,25,PHI,14,0,274,40,86,.465,15,38,.395,25,48,.521,.552,11,16,.688,11,35,46,11,7,3,6,28,106
379,Klay Thompson\thompkl01,SG,26,GSW,14,14,471,110,234,.470,38,109,.349,72,125,.576,.551,27,29,.931,5,36,41,31,10,4,31,33,285
380,Tristan Thompson\thomptr01,C,25,CLE,12,12,338,30,49,.612,0,1,.000,30,48,.625,.612,10,23,.435,39,84,123,12,4,20,4,28,70
381,Marcus Thornton\thornma01,SG,29,WAS,13,1,278,38,105,.362,15,42,.357,23,63,.365,.433,13,14,.929,9,21,30,19,8,0,12,19,104
382,Anthony Tolliver\tollian01,PF,31,SAC,8,0,96,7,19,.368,3,14,.214,4,5,.800,.447,5,5,1.000,6,10,16,5,1,0,4,9,22
383,Karl-Anthony Towns\townska01,C,21,MIN,13,13,459,114,222,.514,22,51,.431,92,171,.538,.563,39,55,.709,41,78,119,31,9,17,26,42,289
384,P.J. Tucker\tuckepj01,SF,31,PHO,15,1,325,18,58,.310,2,22,.091,16,36,.444,.328,21,29,.724,24,62,86,15,18,4,12,31,59
385,Evan Turner\turneev01,SG,28,POR,16,0,387,50,128,.391,5,21,.238,45,107,.421,.410,24,25,.960,10,54,64,41,9,4,21,28,129
386,Myles Turner\turnemy01,C,20,IND,14,14,399,79,146,.541,4,16,.250,75,130,.577,.555,48,62,.774,21,79,100,12,13,33,22,46,210
387,Beno Udrih\udrihbe01,PG,34,DET,15,0,259,43,99,.434,6,17,.353,37,82,.451,.465,16,17,.941,2,24,26,54,4,0,14,15,108
388,Tyler Ulis\ulisty01,PG,21,PHO,8,0,91,13,30,.433,0,3,.000,13,27,.481,.433,7,8,.875,1,6,7,17,13,1,4,8,33
389,Jonas Valanciunas\valanjo01,C,24,TOR,12,12,355,66,116,.569,0,0,,66,116,.569,.569,41,50,.820,39,80,119,11,4,10,16,34,173
390,Denzel Valentine\valende01,SG,23,CHI,11,0,99,8,25,.320,7,19,.368,1,6,.167,.460,1,2,.500,1,13,14,5,1,1,4,13,24
391,Fred VanVleet\vanvlfr01,PG,22,TOR,1,0,0,0,0,,0,0,,0,0,,,0,0,,0,0,0,0,0,0,0,0,0
392,Anderson Varejao\varejan01,C,34,GSW,3,0,13,0,2,.000,0,0,,0,2,.000,.000,3,4,.750,2,3,5,2,1,0,1,3,3
393,Greivis Vasquez\vasqugr01,PG,30,BRK,3,0,39,2,8,.250,1,3,.333,1,5,.200,.313,2,3,.667,0,2,2,5,1,1,1,6,7
394,Rashad Vaughn\vaughra01,SG,20,MIL,9,0,131,21,52,.404,12,33,.364,9,19,.474,.519,0,0,,0,11,11,2,5,4,2,8,54
395,Noah Vonleh\vonleno01,PF,21,POR,13,1,157,16,41,.390,6,17,.353,10,24,.417,.463,8,9,.889,7,38,45,1,3,7,12,21,46
396,Nikola Vucevic\vucevni01,C,26,ORL,14,14,378,68,166,.410,1,4,.250,67,162,.414,.413,13,27,.481,40,112,152,37,7,8,18,30,150
397,Sasha Vujacic\vujacsa01,SG,32,NYK,8,0,55,4,17,.235,1,9,.111,3,8,.375,.265,3,4,.750,0,13,13,5,1,0,5,5,12
398,Dwyane Wade\wadedw01,SG,35,CHI,14,14,428,94,219,.429,19,49,.388,75,170,.441,.473,50,57,.877,19,40,59,40,21,10,27,29,257
399,Dion Waiters\waitedi01,SG,25,MIA,13,13,415,69,185,.373,15,49,.306,54,136,.397,.414,20,34,.588,6,38,44,51,11,10,30,35,173
400,Kemba Walker\walkeke02,PG,26,CHO,13,13,430,110,235,.468,38,92,.413,72,143,.503,.549,63,78,.808,4,50,54,68,23,2,22,17,321
401,John Wall\walljo01,PG,26,WAS,11,11,369,91,206,.442,15,37,.405,76,169,.450,.478,61,74,.824,11,33,44,98,21,8,47,31,258
402,Taurean Waller-Prince\princta02,SF,22,ATL,9,0,94,12,27,.444,2,10,.200,10,17,.588,.481,6,6,1.000,3,17,20,5,3,3,8,9,32
403,T.J. Warren\warretj01,SF,23,PHO,13,13,421,93,203,.458,8,26,.308,85,177,.480,.478,36,44,.818,26,30,56,13,25,4,13,37,230
404,C.J. Watson\watsocj01,PG,32,ORL,12,0,137,6,22,.273,5,8,.625,1,14,.071,.386,7,8,.875,2,15,17,12,7,0,1,10,24
405,David West\westda01,PF,36,GSW,14,0,152,27,51,.529,0,1,.000,27,50,.540,.529,9,12,.750,13,23,36,17,9,7,18,19,63
406,Russell Westbrook\westbru01,PG,28,OKC,15,15,523,162,363,.446,29,84,.345,133,279,.477,.486,124,154,.805,34,110,144,159,19,5,82,39,477
407,Isaiah Whitehead\whiteis01,PG,21,BRK,9,3,152,18,51,.353,2,14,.143,16,37,.432,.373,9,10,.900,5,15,20,24,5,5,20,19,47
408,Hassan Whiteside\whiteha01,C,27,MIA,13,13,432,101,183,.552,0,0,,101,183,.552,.552,42,72,.583,67,140,207,10,12,35,32,44,244
409,Andrew Wiggins\wiggian01,SF,21,MIN,13,13,472,111,241,.461,23,52,.442,88,189,.466,.508,77,104,.740,19,38,57,29,5,7,37,21,322
410,C.J. Wilcox\wilcocj01,SG,26,ORL,6,0,41,2,8,.250,2,7,.286,0,1,.000,.375,2,2,1.000,0,2,2,4,0,0,1,1,8
411,Alan Williams\willial03,PF,24,PHO,6,0,75,15,21,.714,0,0,,15,21,.714,.714,6,12,.500,16,21,37,1,4,7,7,14,36
412,Deron Williams\willide01,PG,32,DAL,6,6,186,27,68,.397,12,31,.387,15,37,.405,.485,9,12,.750,1,10,11,29,3,2,14,13,75
413,Derrick Williams\willide02,SF,25,MIA,7,5,108,18,42,.429,4,13,.308,14,29,.483,.476,3,8,.375,6,9,15,3,2,1,2,6,43
414,Lou Williams\willilo02,SG,30,LAL,15,0,350,83,177,.469,31,72,.431,52,105,.495,.556,52,62,.839,3,28,31,53,22,1,29,16,249
415,Marvin Williams\willima02,PF,30,CHO,13,13,368,44,141,.312,26,80,.325,18,61,.295,.404,16,20,.800,13,71,84,18,4,5,8,24,130
416,Troy Williams\willitr02,SF,22,MEM,9,1,66,7,14,.500,1,5,.200,6,9,.667,.536,6,9,.667,1,1,2,3,5,1,4,9,21
417,Kyle Wiltjer\wiltjky01,PF,24,HOU,3,0,6,0,3,.000,0,3,.000,0,0,,.000,0,0,,0,2,2,0,0,0,2,2,0
418,Justise Winslow\winslju01,SF,20,MIA,9,9,323,42,127,.331,6,28,.214,36,99,.364,.354,14,19,.737,11,31,42,35,15,3,14,29,104
419,Jeff Withey\witheje01,C,26,UTA,11,0,92,8,15,.533,0,1,.000,8,14,.571,.533,11,12,.917,9,12,21,2,4,8,4,12,27
420,Christian Wood\woodch01,PF,21,CHO,1,0,3,0,1,.000,0,1,.000,0,0,,.000,0,0,,0,2,2,0,0,0,0,0,0
421,Metta World Peace\artesro01,SF,37,LAL,4,0,12,0,4,.000,0,2,.000,0,2,.000,.000,2,4,.500,1,0,1,0,1,0,0,4,2
422,James Young\youngja01,SG,21,BOS,9,0,60,6,14,.429,2,7,.286,4,7,.571,.500,0,0,,2,8,10,3,3,0,1,2,14
423,Joe Young\youngjo01,PG,24,IND,11,0,72,13,36,.361,3,10,.300,10,26,.385,.403,4,7,.571,1,9,10,6,1,0,0,3,33
424,Nick Young\youngni01,SG,31,LAL,15,15,406,72,157,.459,40,102,.392,32,55,.582,.586,31,33,.939,6,35,41,19,5,7,12,46,215
425,Thaddeus Young\youngth01,PF,28,IND,15,15,453,75,144,.521,13,30,.433,62,114,.544,.566,8,19,.421,27,67,94,26,21,6,15,23,171
426,Cody Zeller\zelleco01,PF,24,CHO,11,9,258,48,77,.623,0,0,,48,77,.623,.623,33,50,.660,16,37,53,14,6,13,8,37,129
427,Tyler Zeller\zellety01,C,27,BOS,14,4,227,38,77,.494,0,0,,38,77,.494,.494,10,18,.556,21,38,59,18,4,12,8,25,86
428,Stephen Zimmerman\zimmest01,C,20,ORL,2,0,11,1,2,.500,0,0,,1,2,.500,.500,0,1,.000,2,2,4,1,0,0,0,0,2
429,Paul Zipser\zipsepa01,SF,22,CHI,5,0,26,0,5,.000,0,2,.000,0,3,.000,.000,0,0,,1,6,7,3,1,0,1,2,0
430,Ivica Zubac\zubaciv01,C,19,LAL,3,1,27,3,5,.600,0,0,,3,5,.600,.600,1,2,.500,1,4,5,0,1,0,1,6,7
